30 100
GCTCTGATGAGTAATAGAACCGCCTGTTGT|GTCATTGGCCGCTCGTTACACTGGGGGCTT
GCTTACCATATGAGCCCACTGTCCAAGTCA|CCGCGTCAGAGTTACACTGGGGGCTTACCA
TCTATGCTAGGTGGGCGTCATTGGCCGCTC|TGTAGACGTTAGGCATCCCAAGTGGTTTCA
TACACTGGGGGCTTACCATATGAGCCCAGC|ATTTCTCGCGCAGCCGGTTGACTGTAACCA
ATAACCGGTATGTAGACGTTAGGCATCCCA|GCCCAGGATCAGGGGACGGCGGCGGCTCGC
TTACACTGGGGGCTTACCATATGAGCCCAT|AATCACCTGGCTATATGTATGACCGATGCA
GAGCCCAAAAACAAAAGAAACATGTCCAAT|TCTCGTTACACTGGGGGCTTACCATATGAG
TATACACGCCGTTACACTGGGGGCTTACCA|AGAGTGGGAGAGATATTGTTCCGCTTCGAC
TACACTGGGGGCTTACCATATGAGCCCAAA|CAAAAATCCTCGAAGTAACCATCTCGTTAC
GTCCAATGATTAGGTGGGGACTATCCGGCC|ATATGAGCCCAGGGTCCGAATCAAGGAATG
AAATCCCCGCCACTACAGTACACGTTACAC|AACCGCCTGTTGTGATCAGGCTGAGCTCCT
CCATCGTTACACTGGGGGCTTACCATATGA|CTAATGTTACGTCAAGAGAGTGGACACAGG
CATATGAGCCCATTACTAAAGGGCCACGTG|AACGATAAACCCTATTCAGTTACACTGGGG
CGTAGCGGCGAGCGGATTCTCGCTTATGTG|GCGGAAAGTACAACGAGCGCATATGCGTTA
CCCAGCGTCGCACTTCCCGTCTCCCTAAGT|ATATGAGCCCAAAAACAAAAGAAACATGTC
TCGCTATAATAGACAATGGCTCTGATGAGT|GATCTATGCTAGGTGGGCGTCATTGGCCGC
GCTTACCATATGAGCCCAAAAACAAAAGAA|CGAAGTAACCATCTCGTTACACTGGGGGCT
CTTACCATATGAGCCCAGCGGTTACGGGAC|TGAGCCCAATGAGCCCATCGTCCCCGTTCG
CACTGTCCAAGTCAGGGTTCGGATGTCGGC|CTGGGGGCTTACCATATGAGCCCAGCATAT
CACACCGGAAGACAAGAGTGATCACTGGTA|ATGAGCCCAGGATGCTCTTGAAATCCCCGC
GTGTAGTTTGAATGTACACCAGCGCTAACC|TCCAATGATTAGGTGGGGACTATCCGGCCT
GCCCAGAATCTCGTGTTTCGCTATAATAGA|GTCAAATTGTGCAAGTAGATCTATGCTAGG
TGCGACGTTACACTGGGGGCTTACCATATG|ACACTGGGGGCTTACCATATGAGCCCAATG
AGTTACACTGGGGGCTTACCATATGAGCCC|CTTACCATATGAGCCCAGGAACGATAAACC
TTACCATATGAGCCCAGAATCTCGTGTTTC|GGTAAGATCCCGTCAAATTGTGCAAGTAGA
AGTACAACGAGCGCATATGCGTTACACTGG|ACCATATGAGCCCAGAATCTCGTGTTTCGC
GTTACACTGGGGGCTTACCATATGAGCCCA|AGTACACGTTACACGTTACACTGGGGGCTT
TCTCGCAAAACCCTGAACGTAAAGTATAGG|ACGCCGTTACACTGGGGGCTTACCATATGA
GGGGCTTACCATATGAGCCCAGAATCTCGT|TCTGTGGTAAGATCCCGTCAAATTGTGCAA
CGTCTCCCTAAGTGTAGTTTGAATGTACAC|AAAGAAACATGTCCAATGATTAGGTGGGGA
ACGTAAAGTATAGGATAACCGGTATGTAGA|GGCTTACCATATGAGCCCAGGATCAGGGGA
ACTGGGGGCTTACCATATGAGCCCAGGATG|TTCGCTATAATAGACAATGGCTCTGATGAG
CCCTGAACGTAAAGTATAGGATAACCGGTA|ACTGGGGGCTTACCATATGAGCCCAGGATC
TAAATAGGGTTACACTGGGGGCTTACCATA|GCCACTACAGTACACGTTACACGTTACACT
CCAGCATATACACGCCGTTACACTGGGGGC|AACCAGAGAGTGGGAGAGATATTGTTCCGC
CATTCTGTGGTAAGATCCCGTCAAATTGTG|TCGCAAAACCCTGAACGTAAAGTATAGGAT
CCAGCGGTTACGGGACCGACGAGCAAAGCT|CCATCGTCCCCGTTCGTATTTCTTAGTTTC
ATGAGCCCACTGTCCAAGTCAGGGTTCGGA|AGTTACACTGGGGGCTTACCATATGAGCCC
ACACTGGGGGCTTACCATATGAGCCCAAAA|AAAAATCCTCGAAGTAACCATCTCGTTACA
TTACCATATGAGCCCAGCGGTTACGGGACC|GAGCCCAATGAGCCCATCGTCCCCGTTCGT
TGGCGGAGACAGCACACCGGAAGACAAGAG|GGGGCTTACCATATGAGCCCAGGATGCTCT
AGGATGCTCTTGAAATCCCCGCCACTACAG|GATGAGTAATAGAACCGCCTGTTGTGATCA
CACGTGTCCACACCCCAGCGTCGCACTTCC|CTGGGGGCTTACCATATGAGCCCAAAAACA
TTACCATATGAGCCCAGGCGTGCGCTGCGG|GTTACACTGGGGGCTTACCATATGAGCCCA
TGTTTCGCTATAATAGACAATGGCTCTGAT|AGTAGATCTATGCTAGGTGGGCGTCATTGG
CTCGTTACACTGGGGGCTTACCATATGAGC|TCATAAAGGCTGTAACCGCGTCAGAGTTAC
TTACACGTTACACTGGGGGCTTACCATATG|GCTCCTGAATCACCTGGCTATATGTATGAC
AAAGGCTGTAACCGCGTCAGAGTTACACTG|AAACCATGACAGCCACTAATGTTATTTCTC
CATATGAGCCCAGCGGTTACGGGACCGACG|CCAATGAGCCCATCGTCCCCGTTCGTATTT
GGAAAGTACAACGAGCGCATATGCGTTACA|GCTTACCATATGAGCCCAGAATCTCGTGTT
CGAGGGAGGAAGCTTCGTAGCGGCGAGCGG|CGTGCGCTGCGGTGGGCGGAAAGTACAACG
TACGTCAAGAGAGTGGACACAGGCTGAGCT|GACGCCTGGTGCGACGTTACACTGGGGGCT
TCGTCCCCGTTCGTATTTCTTAGTTTCCAT|CACTGGTAAATAGGGTTACACTGGGGGCTT
GTCCGAGACGCCTGGTGCGACGTTACACTG|CATATGAGCCCAGTTACACTGGGGGCTTAC
TATGAGCCCAGGCGTGCGCTGCGGTGGGCG|CTGGGGGCTTACCATATGAGCCCATGGGGG
TCCGAGACGCCTGGTGCGACGTTACACTGG|ATATGAGCCCAGTTACACTGGGGGCTTACC
CACCCCAGCGTCGCACTTCCCGTCTCCCTA|ACCATATGAGCCCAAAAACAAAAGAAACAT
CGTTAGGCATCCCAAGTGGTTTCATAAAGG|CGGCGGCGGCTCGCGGGACTTCCTGAAACC
TGTCCAATGATTAGGTGGGGACTATCCGGC|CATATGAGCCCAGGGTCCGAATCAAGGAAT
CAAAAACAAAAGAAACATGTCCAATGATTA|TTACACTGGGGGCTTACCATATGAGCCCAG
CCAATGATTAGGTGGGGACTATCCGGCCTA|ATGAGCCCAGGGTCCGAATCAAGGAATGGT
AGCCCATCGTCCCCGTTCGTATTTCTTAGT|AGTGATCACTGGTAAATAGGGTTACACTGG
CCCAGGAACGATAAACCCTATTCAGTTACA|TGAGCTCACTGGGGGTATAAGGTGCACAAA
AATGGCTCTGATGAGTAATAGAACCGCCTG|GGGCGTCATTGGCCGCTCGTTACACTGGGG
TCAGGGTTCGGATGTCGGCATTCTCGCAAA|CCATATGAGCCCAGCATATACACGCCGTTA
GGCTTACCATATGAGCCCAAAAACAAAAGA|TCGAAGTAACCATCTCGTTACACTGGGGGC
TTGGCGGAGACAGCACACCGGAAGACAAGA|GGGGGCTTACCATATGAGCCCAGGATGCTC
AGGCTGAGCTCCTGAATCACCTGGCTATAT|TATGAGCCCACTGTCCAAGTCAGGGTTCGG
CCACTGTCCAAGTCAGGGTTCGGATGTCGG|ACTGGGGGCTTACCATATGAGCCCAGCATA
CAGTACACGTTACACGTTACACTGGGGGCT|TCAGGCTGAGCTCCTGAATCACCTGGCTAT
GTACAACGAGCGCATATGCGTTACACTGGG|CCATATGAGCCCAGAATCTCGTGTTTCGCT
ATATGAGCCCAGGGTCCGAATCAAGGAATG|GGGGCTTACCATGTTACACTGGGGGCTTAC
AGGGAGGAAGCTTCGTAGCGGCGAGCGGAT|TGCGCTGCGGTGGGCGGAAAGTACAACGAG
AAAAGAAACATGTCCAATGATTAGGTGGGG|GGGGGCTTACCATATGAGCCCAGGGTCCGA
GGCTTACCATATGAGCCCACTGTCCAAGTC|ACCGCGTCAGAGTTACACTGGGGGCTTACC
TCCATGGCCAGCTACTACGATCGAGGGAGG|GGCTTACCATATGAGCCCAGGCGTGCGCTG
GTTAGGCATCCCAAGTGGTTTCATAAAGGC|GGCGGCGGCTCGCGGGACTTCCTGAAACCA
GGCTTACCATATGAGCCCATGGGGGCTTAC|CTATATGTATGACCGATGCATTCTGTGGTA
ACGAGCGCATATGCGTTACACTGGGGGCTT|TGAGCCCAGAATCTCGTGTTTCGCTATAAT
AACATGTCCAATGATTAGGTGGGGACTATC|TTACCATATGAGCCCAGGGTCCGAATCAAG
GGATTGGCGGAGACAGCACACCGGAAGACA|ACTGGGGGCTTACCATATGAGCCCAGGATG
AAGTATAGGATAACCGGTATGTAGACGTTA|ACCATATGAGCCCAGGATCAGGGGACGGCG
TATAATAGACAATGGCTCTGATGAGTAATA|TATGCTAGGTGGGCGTCATTGGCCGCTCGT
ACCTATATACGCCCACATAGGGAGTTACAC|CTAACCATCGTTACACTGGGGGCTTACCAT
GCTCCTGAATCACCTGGCTATATGTATGAC|CCACTGTCCAAGTCAGGGTTCGGATGTCGG
GGCGTCATTGGCCGCTCGTTACACTGGGGG|CATCCCAAGTGGTTTCATAAAGGCTGTAAC
CCTAAGTGTAGTTTGAATGTACACCAGCGC|ACATGTCCAATGATTAGGTGGGGACTATCC
CATTACTAAAGGGCCACGTGTCCACACCCC|CCTATTCAGTTACACTGGGGGCTTACCATA
ACGTCAAGAGAGTGGACACAGGCTGAGCTC|ACGCCTGGTGCGACGTTACACTGGGGGCTT
CAGTTACACTGGGGGCTTACCATATGAGCC|TGCACAAAAATCCTCGAAGTAACCATCTCG
GACAGCACACCGGAAGACAAGAGTGATCAC|ACCATATGAGCCCAGGATGCTCTTGAAATC
TGCGGATTGGCGGAGACAGCACACCGGAAG|TACACTGGGGGCTTACCATATGAGCCCAGG
TTGAAATCCCCGCCACTACAGTACACGTTA|TAGAACCGCCTGTTGTGATCAGGCTGAGCT
ATCAAGGAATGGTCCGAGACGCCTGGTGCG|TGGGGGCTTACCATATGAGCCCAGTTACAC
GATTAGGTGGGGACTATCCGGCCTAATGTT|CCCAGGGTCCGAATCAAGGAATGGTCCGAG
CGAGCGCATATGCGTTACACTGGGGGCTTA|GAGCCCAGAATCTCGTGTTTCGCTATAATA
GGGCGGAAAGTACAACGAGCGCATATGCGT|GGGGGCTTACCATATGAGCCCAGAATCTCG
TAAAGGGCCACGTGTCCACACCCCAGCGTC|CAGTTACACTGGGGGCTTACCATATGAGCC
TGGTCCGAGACGCCTGGTGCGACGTTACAC|ACCATATGAGCCCAGTTACACTGGGGGCTT
CCCATCGTCCCCGTTCGTATTTCTTAGTTT|TGATCACTGGTAAATAGGGTTACACTGGGG
CGGAGACAGCACACCGGAAGACAAGAGTGA|GCTTACCATATGAGCCCAGGATGCTCTTGA
CATCCCAAGTGGTTTCATAAAGGCTGTAAC|GGCTCGCGGGACTTCCTGAAACCATGACAG
GGGCTTACCATATGAGCCCAGCATATACAC|CGCAGCCGGTTGACTGTAACCAGAGAGTGG
GTTGTGATCAGGCTGAGCTCCTGAATCACC|GGCTTACCATATGAGCCCACTGTCCAAGTC
ACTGGGGGCTTACCATATGAGCCCAGTTAC|CGGCGAGCGGATTCTCGCTTATGTGCGGAT
TGAGCCCAGGCGTGCGCTGCGGTGGGCGGA|GGGGGCTTACCATATGAGCCCATGGGGGCT
ACACTGGGGGCTTACCATATGAGCCCAATG|ATTGGCGGAGACAGCACACCGGAAGACAAG
GGAGACAGCACACCGGAAGACAAGAGTGAT|CTTACCATATGAGCCCAGGATGCTCTTGAA
GGGGGCTTACCATATGAGCCCATTACTAAA|TGAGCCCAGGAACGATAAACCCTATTCAGT
GATAACCGGTATGTAGACGTTAGGCATCCC|AGCCCAGGATCAGGGGACGGCGGCGGCTCG
GTATAGGATAACCGGTATGTAGACGTTAGG|CATATGAGCCCAGGATCAGGGGACGGCGGC
AGCGCTAACCATCGTTACACTGGGGGCTTA|TATCCGGCCTAATGTTACGTCAAGAGAGTG
ACCATATGAGCCCAGGAACGATAAACCCTA|GGACACAGGCTGAGCTCACTGGGGGTATAA
TCCGGCCTAATGTTACGTCAAGAGAGTGGA|AGGAATGGTCCGAGACGCCTGGTGCGACGT
GCCCATGGGGGCTTACCATATGAGCCCAGA|GATGCATTCTGTGGTAAGATCCCGTCAAAT
ATTGGCCGCTCGTTACACTGGGGGCTTACC|AAGTGGTTTCATAAAGGCTGTAACCGCGTC
CGGTGGGCGGAAAGTACAACGAGCGCATAT|CCATGGGGGCTTACCATATGAGCCCAGAAT
CAAGTCAGGGTTCGGATGTCGGCATTCTCG|CTTACCATATGAGCCCAGCATATACACGCC
GCGGCGAGCGGATTCTCGCTTATGTGCGGA|AAAGTACAACGAGCGCATATGCGTTACACT
CACTGGGGGCTTACCATATGAGCCCAGGAT|TTTCGCTATAATAGACAATGGCTCTGATGA
TCCCTAAGTGTAGTTTGAATGTACACCAGC|AAACATGTCCAATGATTAGGTGGGGACTAT
GGGCTTACCATATGAGCCCATGGGGGCTTA|GCTATATGTATGACCGATGCATTCTGTGGT
GCTATATGTATGACCGATGCATTCTGTGGT|GGTTCGGATGTCGGCATTCTCGCAAAACCC
GCTTATGTGCGGATTGGCGGAGACAGCACA|TATGCGTTACACTGGGGGCTTACCATATGA
GGGCTTACCATATGAGCCCATTACTAAAGG|AGCCCAGGAACGATAAACCCTATTCAGTTA
GCCACGTGTCCACACCCCAGCGTCGCACTT|CACTGGGGGCTTACCATATGAGCCCAAAAA
TATGAGCCCAATGAGCCCATCGTCCCCGTT|ACCGGAAGACAAGAGTGATCACTGGTAAAT
TGGCTATATGTATGACCGATGCATTCTGTG|AGGGTTCGGATGTCGGCATTCTCGCAAAAC
ACACTGGGGGCTTACCATATGAGCCCAGGA|GTTTCGCTATAATAGACAATGGCTCTGATG
GAAGACAAGAGTGATCACTGGTAAATAGGG|CAGGATGCTCTTGAAATCCCCGCCACTACA
CGTCATTGGCCGCTCGTTACACTGGGGGCT|TCCCAAGTGGTTTCATAAAGGCTGTAACCG
ACACTGGGGGCTTACCATATGAGCCCAGTT|AGCGGCGAGCGGATTCTCGCTTATGTGCGG
TTCAGTTACACTGGGGGCTTACCATATGAG|GGTGCACAAAAATCCTCGAAGTAACCATCT
GAACCGCCTGTTGTGATCAGGCTGAGCTCC|TACACTGGGGGCTTACCATATGAGCCCACT
GGCCTAATGTTACGTCAAGAGAGTGGACAC|AATGGTCCGAGACGCCTGGTGCGACGTTAC
ACTGGGGGCTTACCATATGAGCCCAGGCGT|ACGTTACACGTTACACTGGGGGCTTACCAT
CCATATGAGCCCAGTTACACTGGGGGCTTA|TCTCGCTTATGTGCGGATTGGCGGAGACAG
GAGGAAGCTTCGTAGCGGCGAGCGGATTCT|GCTGCGGTGGGCGGAAAGTACAACGAGCGC
ACAGTACACGTTACACGTTACACTGGGGGC|ATCAGGCTGAGCTCCTGAATCACCTGGCTA
GATGCTCTTGAAATCCCCGCCACTACAGTA|TGAGTAATAGAACCGCCTGTTGTGATCAGG
GGTATAAGGTGCACAAAAATCCTCGAAGTA|TGAGCCCAGCGGTTACGGGACCGACGAGCA
GTGCACAAAAATCCTCGAAGTAACCATCTC|GCGGTTACGGGACCGACGAGCAAAGCTAAA
AATGTACACCAGCGCTAACCATCGTTACAC|AGGTGGGGACTATCCGGCCTAATGTTACGT
GCGTCATTGGCCGCTCGTTACACTGGGGGC|ATCCCAAGTGGTTTCATAAAGGCTGTAACC
ACGATCGAGGGAGGAAGCTTCGTAGCGGCG|CCAGGCGTGCGCTGCGGTGGGCGGAAAGTA
ATGACCGATGCATTCTGTGGTAAGATCCCG|GTCGGCATTCTCGCAAAACCCTGAACGTAA
TGTCCACACCCCAGCGTCGCACTTCCCGTC|GGGCTTACCATATGAGCCCAAAAACAAAAG
CTTGGTTACACTGGGGGCTTACCATGTTAC|CTACTACGATCGAGGGAGGAAGCTTCGTAG
TTTCGCTATAATAGACAATGGCTCTGATGA|TAGATCTATGCTAGGTGGGCGTCATTGGCC
TCCCCGTTCGTATTTCTTAGTTTCCATGGC|TGGTAAATAGGGTTACACTGGGGGCTTACC
TCGTTACACTGGGGGCTTACCATATGAGCC|CATAAAGGCTGTAACCGCGTCAGAGTTACA
GCACAAAAATCCTCGAAGTAACCATCTCGT|GGTTACGGGACCGACGAGCAAAGCTAAAGG
AGTACACGTTACACGTTACACTGGGGGCTT|CAGGCTGAGCTCCTGAATCACCTGGCTATA
CACTGGGGGCTTACCATATGAGCCCAAAAA|AAAATCCTCGAAGTAACCATCTCGTTACAC
GCTTACCATATGAGCCCAGCGGTTACGGGA|ATGAGCCCAATGAGCCCATCGTCCCCGTTC
AGGTGCACAAAAATCCTCGAAGTAACCATC|CAGCGGTTACGGGACCGACGAGCAAAGCTA
TTCTTAGTTTCCATGGCCAGCTACTACGAT|TACACTGGGGGCTTACCATATGAGCCCAGG
TACCATATGAGCCCAGAATCTCGTGTTTCG|GTAAGATCCCGTCAAATTGTGCAAGTAGAT
AAGTGTAGTTTGAATGTACACCAGCGCTAA|TGTCCAATGATTAGGTGGGGACTATCCGGC
CAGGCTGAGCTCACTGGGGGTATAAGGTGC|CACTGGGGGCTTACCATATGAGCCCAGCGG
CACGTTACACGTTACACTGGGGGCTTACCA|CTGAGCTCCTGAATCACCTGGCTATATGTA
CGAGCGGATTCTCGCTTATGTGCGGATTGG|TACAACGAGCGCATATGCGTTACACTGGGG
TTACCATATGAGCCCAATGAGCCCATCGTC|CAGCACACCGGAAGACAAGAGTGATCACTG
GCAAAACCCTGAACGTAAAGTATAGGATAA|CGTTACACTGGGGGCTTACCATATGAGCCC
TACACTGGGGGCTTACCATATGAGCCCATT|ACCATATGAGCCCAGGAACGATAAACCCTA
TATAGGATAACCGGTATGTAGACGTTAGGC|ATATGAGCCCAGGATCAGGGGACGGCGGCG
AACGTAAAGTATAGGATAACCGGTATGTAG|GGGCTTACCATATGAGCCCAGGATCAGGGG
AGCTCACTGGGGGTATAAGGTGCACAAAAA|GGCTTACCATATGAGCCCAGCGGTTACGGG
ATGGGGGCTTACCATATGAGCCCAGAATCT|CATTCTGTGGTAAGATCCCGTCAAATTGTG
ATTCTGTGGTAAGATCCCGTCAAATTGTGC|CGCAAAACCCTGAACGTAAAGTATAGGATA
GGGTCCGAATCAAGGAATGGTCCGAGACGC|TGTTACACTGGGGGCTTACCATATGAGCCC
GATTGGCGGAGACAGCACACCGGAAGACAA|CTGGGGGCTTACCATATGAGCCCAGGATGC
AAGTAACCATCTCGTTACACTGGGGGCTTA|GAGCAAAGCTAAAGGCTCCCTTGGTTACAC
TTACCATATGAGCCCAGTTACACTGGGGGC|GATTCTCGCTTATGTGCGGATTGGCGGAGA
AAATAGGGTTACACTGGGGGCTTACCATAT|CCACTACAGTACACGTTACACGTTACACTG
ACGTTAGGCATCCCAAGTGGTTTCATAAAG|ACGGCGGCGGCTCGCGGGACTTCCTGAAAC
TGGCCAGCTACTACGATCGAGGGAGGAAGC|TACCATATGAGCCCAGGCGTGCGCTGCGGT
GGCTTACCATATGAGCCCATTACTAAAGGG|GCCCAGGAACGATAAACCCTATTCAGTTAC
GGGGGCTTACCATATGAGCCCAGTTACACT|CGAGCGGATTCTCGCTTATGTGCGGATTGG
ACCTGGCTATATGTATGACCGATGCATTCT|GTCAGGGTTCGGATGTCGGCATTCTCGCAA
CTAAGTGTAGTTTGAATGTACACCAGCGCT|CATGTCCAATGATTAGGTGGGGACTATCCG
TGGGGGCTTACCATATGAGCCCAGGATGCT|CGCTATAATAGACAATGGCTCTGATGAGTA
TAGACGTTAGGCATCCCAAGTGGTTTCATA|GGGACGGCGGCGGCTCGCGGGACTTCCTGA
TCAGTTACACTGGGGGCTTACCATATGAGC|GTGCACAAAAATCCTCGAAGTAACCATCTC
ATGAGCCCATTACTAAAGGGCCACGTGTCC|GATAAACCCTATTCAGTTACACTGGGGGCT
ATATGAGCCCAGGCGTGCGCTGCGGTGGGC|ACTGGGGGCTTACCATATGAGCCCATGGGG
AGGAACGATAAACCCTATTCAGTTACACTG|GCTCACTGGGGGTATAAGGTGCACAAAAAT
CGCTATAATAGACAATGGCTCTGATGAGTA|ATCTATGCTAGGTGGGCGTCATTGGCCGCT
TACCATATGAGCCCATGGGGGCTTACCATA|ATGTATGACCGATGCATTCTGTGGTAAGAT
CAGGGTCCGAATCAAGGAATGGTCCGAGAC|CATGTTACACTGGGGGCTTACCATATGAGC
TTGGCCGCTCGTTACACTGGGGGCTTACCA|AGTGGTTTCATAAAGGCTGTAACCGCGTCA
GAGCCCAGGCGTGCGCTGCGGTGGGCGGAA|GGGGCTTACCATATGAGCCCATGGGGGCTT
ACCCTGAACGTAAAGTATAGGATAACCGGT|CACTGGGGGCTTACCATATGAGCCCAGGAT
TGGCCGCTCGTTACACTGGGGGCTTACCAT|GTGGTTTCATAAAGGCTGTAACCGCGTCAG
AGCCCACTGTCCAAGTCAGGGTTCGGATGT|TACACTGGGGGCTTACCATATGAGCCCAGC
TAACCATCGTTACACTGGGGGCTTACCATA|GGCCTAATGTTACGTCAAGAGAGTGGACAC
GTACACCAGCGCTAACCATCGTTACACTGG|TGGGGACTATCCGGCCTAATGTTACGTCAA
TACCATATGAGCCCAGCGGTTACGGGACCG|AGCCCAATGAGCCCATCGTCCCCGTTCGTA
GTTACACGTTACACTGGGGGCTTACCATAT|AGCTCCTGAATCACCTGGCTATATGTATGA
ATTACTAAAGGGCCACGTGTCCACACCCCA|CTATTCAGTTACACTGGGGGCTTACCATAT
GGTTACGGGACCGACGAGCAAAGCTAAAGG|GTCCCCGTTCGTATTTCTTAGTTTCCATGG
ACAGGCTGAGCTCACTGGGGGTATAAGGTG|ACACTGGGGGCTTACCATATGAGCCCAGCG
AAATCCTCGAAGTAACCATCTCGTTACACT|GGGACCGACGAGCAAAGCTAAAGGCTCCCT
AATGAGCCCATCGTCCCCGTTCGTATTTCT|CAAGAGTGATCACTGGTAAATAGGGTTACA
ATGAGCCCAGCGGTTACGGGACCGACGAGC|ATGAGCCCATCGTCCCCGTTCGTATTTCTT
TACGCCCACATAGGGAGTTACACTGGGGGC|TCGTTACACTGGGGGCTTACCATATGAGCC
TCGAGGGAGGAAGCTTCGTAGCGGCGAGCG|GCGTGCGCTGCGGTGGGCGGAAAGTACAAC
CACACCCCAGCGTCGCACTTCCCGTCTCCC|TTACCATATGAGCCCAAAAACAAAAGAAAC
GAATGTACACCAGCGCTAACCATCGTTACA|TAGGTGGGGACTATCCGGCCTAATGTTACG
TACAACGAGCGCATATGCGTTACACTGGGG|CATATGAGCCCAGAATCTCGTGTTTCGCTA
TCCTGAATCACCTGGCTATATGTATGACCG|ACTGTCCAAGTCAGGGTTCGGATGTCGGCA
GTTCGGATGTCGGCATTCTCGCAAAACCCT|TGAGCCCAGCATATACACGCCGTTACACTG
CAAGAGTGATCACTGGTAAATAGGGTTACA|TGCTCTTGAAATCCCCGCCACTACAGTACA
GAGAGTGGACACAGGCTGAGCTCACTGGGG|GTGCGACGTTACACTGGGGGCTTACCATAT
AGTTTGAATGTACACCAGCGCTAACCATCG|ATGATTAGGTGGGGACTATCCGGCCTAATG
TTACACTGGGGGCTTACCATGTTACACTGG|ACGATCGAGGGAGGAAGCTTCGTAGCGGCG
GTCCCCGTTCGTATTTCTTAGTTTCCATGG|CTGGTAAATAGGGTTACACTGGGGGCTTAC
TAATGTTACGTCAAGAGAGTGGACACAGGC|GTCCGAGACGCCTGGTGCGACGTTACACTG
CAGCTACTACGATCGAGGGAGGAAGCTTCG|ATATGAGCCCAGGCGTGCGCTGCGGTGGGC
ATGAGCCCAGAATCTCGTGTTTCGCTATAA|TCCCGTCAAATTGTGCAAGTAGATCTATGC
GGCCGCTCGTTACACTGGGGGCTTACCATA|TGGTTTCATAAAGGCTGTAACCGCGTCAGA
ACACTGGGGGCTTACCATATGAGCCCATTA|CCATATGAGCCCAGGAACGATAAACCCTAT
ACGCCGTTACACTGGGGGCTTACCATATGA|GGGAGAGATATTGTTCCGCTTCGACACAGG
ATATGAGCCCACTGTCCAAGTCAGGGTTCG|AGAGTTACACTGGGGGCTTACCATATGAGC
AAAACAAAAGAAACATGTCCAATGATTAGG|ACACTGGGGGCTTACCATATGAGCCCAGGG
GGAAGCTTCGTAGCGGCGAGCGGATTCTCG|TGCGGTGGGCGGAAAGTACAACGAGCGCAT
CACTGGGGGCTTACCATATGAGCCCATGGG|CACCTGGCTATATGTATGACCGATGCATTC
AGGGTCCGAATCAAGGAATGGTCCGAGACG|ATGTTACACTGGGGGCTTACCATATGAGCC
GCCCATCGTCCCCGTTCGTATTTCTTAGTT|GTGATCACTGGTAAATAGGGTTACACTGGG
AACCCTATTCAGTTACACTGGGGGCTTACC|GGTATAAGGTGCACAAAAATCCTCGAAGTA
CGCCACTACAGTACACGTTACACGTTACAC|TGTTGTGATCAGGCTGAGCTCCTGAATCAC
TGGCTCTGATGAGTAATAGAACCGCCTGTT|GCGTCATTGGCCGCTCGTTACACTGGGGGC
TGGGGGTATAAGGTGCACAAAAATCCTCGA|CATATGAGCCCAGCGGTTACGGGACCGACG
CCATATGAGCCCAGCATATACACGCCGTTA|GGTTGACTGTAACCAGAGAGTGGGAGAGAT
AGCGGATTCTCGCTTATGTGCGGATTGGCG|CAACGAGCGCATATGCGTTACACTGGGGGC
TCCCGTCTCCCTAAGTGTAGTTTGAATGTA|ACAAAAGAAACATGTCCAATGATTAGGTGG
CTAGGTGGGCGTCATTGGCCGCTCGTTACA|CGTTAGGCATCCCAAGTGGTTTCATAAAGG
GCTGAGCTCACTGGGGGTATAAGGTGCACA|TGGGGGCTTACCATATGAGCCCAGCGGTTA
ACTGGGGGCTTACCATATGAGCCCATGGGG|ACCTGGCTATATGTATGACCGATGCATTCT
GGGCTTACCATATGAGCCCAAAAACAAAAG|CTCGAAGTAACCATCTCGTTACACTGGGGG
AACCTATATACGCCCACATAGGGAGTTACA|GCTAACCATCGTTACACTGGGGGCTTACCA
GACACAGGCTGAGCTCACTGGGGGTATAAG|GTTACACTGGGGGCTTACCATATGAGCCCA
AATAGAACCGCCTGTTGTGATCAGGCTGAG|TCGTTACACTGGGGGCTTACCATATGAGCC
GGCTGTAACCGCGTCAGAGTTACACTGGGG|CCATGACAGCCACTAATGTTATTTCTCGCG
CGGTATGTAGACGTTAGGCATCCCAAGTGG|GGATCAGGGGACGGCGGCGGCTCGCGGGAC
CCTATTCAGTTACACTGGGGGCTTACCATA|ATAAGGTGCACAAAAATCCTCGAAGTAACC
ACTAAAGGGCCACGTGTCCACACCCCAGCG|TTCAGTTACACTGGGGGCTTACCATATGAG
CCAATGAGCCCATCGTCCCCGTTCGTATTT|GACAAGAGTGATCACTGGTAAATAGGGTTA
TACACTGGGGGCTTACCATATGAGCCCACT|AAGGCTGTAACCGCGTCAGAGTTACACTGG
AGAACCGCCTGTTGTGATCAGGCTGAGCTC|TTACACTGGGGGCTTACCATATGAGCCCAC
CCGCCACTACAGTACACGTTACACGTTACA|CTGTTGTGATCAGGCTGAGCTCCTGAATCA
GGGGGCTTACCATATGAGCCCAGGGTCCGA|TGGTTACACTGGGGGCTTACCATGTTACAC
GATCGAGGGAGGAAGCTTCGTAGCGGCGAG|AGGCGTGCGCTGCGGTGGGCGGAAAGTACA
CCCTATTCAGTTACACTGGGGGCTTACCAT|TATAAGGTGCACAAAAATCCTCGAAGTAAC
GATCTATGCTAGGTGGGCGTCATTGGCCGC|TATGTAGACGTTAGGCATCCCAAGTGGTTT
CGGATTGGCGGAGACAGCACACCGGAAGAC|CACTGGGGGCTTACCATATGAGCCCAGGAT
CTAAAGGCTCCCTTGGTTACACTGGGGGCT|TCCATGGCCAGCTACTACGATCGAGGGAGG
AGTTTCCATGGCCAGCTACTACGATCGAGG|TGGGGGCTTACCATATGAGCCCAGGCGTGC
CGCTAACCATCGTTACACTGGGGGCTTACC|TCCGGCCTAATGTTACGTCAAGAGAGTGGA
GCCCAAAAACAAAAGAAACATGTCCAATGA|TCGTTACACTGGGGGCTTACCATATGAGCC
GGCCACGTGTCCACACCCCAGCGTCGCACT|ACACTGGGGGCTTACCATATGAGCCCAAAA
TTACCATATGAGCCCAGCATATACACGCCG|GCCGGTTGACTGTAACCAGAGAGTGGGAGA
GTAAGATCCCGTCAAATTGTGCAAGTAGAT|CCTGAACGTAAAGTATAGGATAACCGGTAT
GGATTCTCGCTTATGTGCGGATTGGCGGAG|CGAGCGCATATGCGTTACACTGGGGGCTTA
AGAGTGATCACTGGTAAATAGGGTTACACT|CTCTTGAAATCCCCGCCACTACAGTACACG
TTACACTGGGGGCTTACCATATGAGCCCAG|GGGCTTACCATATGAGCCCAATGAGCCCAT
ACCATATGAGCCCAGGGTCCGAATCAAGGA|CTGGGGGCTTACCATGTTACACTGGGGGCT
ATTCTCGCAAAACCCTGAACGTAAAGTATA|ACACGCCGTTACACTGGGGGCTTACCATAT
CCCAGCGGTTACGGGACCGACGAGCAAAGC|CCCATCGTCCCCGTTCGTATTTCTTAGTTT
CCAGAATCTCGTGTTTCGCTATAATAGACA|CAAATTGTGCAAGTAGATCTATGCTAGGTG
CCGGCCTAATGTTACGTCAAGAGAGTGGAC|GGAATGGTCCGAGACGCCTGGTGCGACGTT
ACAAAAGAAACATGTCCAATGATTAGGTGG|CTGGGGGCTTACCATATGAGCCCAGGGTCC
GAGCCCAGGAACGATAAACCCTATTCAGTT|GGCTGAGCTCACTGGGGGTATAAGGTGCAC
AGTGGACACAGGCTGAGCTCACTGGGGGTA|CGACGTTACACTGGGGGCTTACCATATGAG
ATAGGGTTACACTGGGGGCTTACCATATGA|ACTACAGTACACGTTACACGTTACACTGGG
CTTACCATATGAGCCCAGGGTCCGAATCAA|ACACTGGGGGCTTACCATGTTACACTGGGG
GGATGTCGGCATTCTCGCAAAACCCTGAAC|CCCAGCATATACACGCCGTTACACTGGGGG
GATCCCGTCAAATTGTGCAAGTAGATCTAT|AACGTAAAGTATAGGATAACCGGTATGTAG
ACCATATGAGCCCAGGATGCTCTTGAAATC|AGACAATGGCTCTGATGAGTAATAGAACCG
TATTCAGTTACACTGGGGGCTTACCATATG|AAGGTGCACAAAAATCCTCGAAGTAACCAT
TTACCATATGAGCCCAGGAACGATAAACCC|GTGGACACAGGCTGAGCTCACTGGGGGTAT
ATGCATTCTGTGGTAAGATCCCGTCAAATT|TTCTCGCAAAACCCTGAACGTAAAGTATAG
GCGCTAACCATCGTTACACTGGGGGCTTAC|ATCCGGCCTAATGTTACGTCAAGAGAGTGG
TTACACTGGGGGCTTACCATATGAGCCCAG|GCTCCCTTGGTTACACTGGGGGCTTACCAT
TACCATATGAGCCCAGGCGTGCGCTGCGGT|TTACACTGGGGGCTTACCATATGAGCCCAT
CACTGGGGGCTTACCATATGAGCCCAGCGG|CTTACCATATGAGCCCAATGAGCCCATCGT
AATCAAGGAATGGTCCGAGACGCCTGGTGC|CTGGGGGCTTACCATATGAGCCCAGTTACA
ACTGGGGGCTTACCATATGAGCCCATTACT|ATATGAGCCCAGGAACGATAAACCCTATTC
AGATCCCGTCAAATTGTGCAAGTAGATCTA|GAACGTAAAGTATAGGATAACCGGTATGTA
AGCATATACACGCCGTTACACTGGGGGCTT|CCAGAGAGTGGGAGAGATATTGTTCCGCTT
CGTGTCCACACCCCAGCGTCGCACTTCCCG|GGGGGCTTACCATATGAGCCCAAAAACAAA
AGCCCATTACTAAAGGGCCACGTGTCCACA|AAACCCTATTCAGTTACACTGGGGGCTTAC
GTTTCATAAAGGCTGTAACCGCGTCAGAGT|CTTCCTGAAACCATGACAGCCACTAATGTT
CCCAGCATATACACGCCGTTACACTGGGGG|TAACCAGAGAGTGGGAGAGATATTGTTCCG
CCGGAAGACAAGAGTGATCACTGGTAAATA|GCCCAGGATGCTCTTGAAATCCCCGCCACT
CATATGAGCCCAGCATATACACGCCGTTAC|GTTGACTGTAACCAGAGAGTGGGAGAGATA
TCGTTACACTGGGGGCTTACCATATGAGCC|AAGGCTCCCTTGGTTACACTGGGGGCTTAC
AGCCCAAAAACAAAAGAAACATGTCCAATG|CTCGTTACACTGGGGGCTTACCATATGAGC
GAGTGGACACAGGCTGAGCTCACTGGGGGT|GCGACGTTACACTGGGGGCTTACCATATGA
CAGCGGTTACGGGACCGACGAGCAAAGCTA|CATCGTCCCCGTTCGTATTTCTTAGTTTCC
GGGGGTATAAGGTGCACAAAAATCCTCGAA|ATATGAGCCCAGCGGTTACGGGACCGACGA
CCCAGGCGTGCGCTGCGGTGGGCGGAAAGT|GCTTACCATATGAGCCCATGGGGGCTTACC
CCAGCGTCGCACTTCCCGTCTCCCTAAGTG|TATGAGCCCAAAAACAAAAGAAACATGTCC
TTCATAAAGGCTGTAACCGCGTCAGAGTTA|TCCTGAAACCATGACAGCCACTAATGTTAT
CCATGTTACACTGGGGGCTTACCATATGAG|GCTTCGTAGCGGCGAGCGGATTCTCGCTTA
GGGACCGACGAGCAAAGCTAAAGGCTCCCT|GTTCGTATTTCTTAGTTTCCATGGCCAGCT
GGGGGCTTACCATATGAGCCCAATGAGCCC|CGGAGACAGCACACCGGAAGACAAGAGTGA
CAGAATCTCGTGTTTCGCTATAATAGACAA|AAATTGTGCAAGTAGATCTATGCTAGGTGG
ATCTATGCTAGGTGGGCGTCATTGGCCGCT|ATGTAGACGTTAGGCATCCCAAGTGGTTTC
AGCTTCGTAGCGGCGAGCGGATTCTCGCTT|GGTGGGCGGAAAGTACAACGAGCGCATATG
ACCATATGAGCCCATGGGGGCTTACCATAT|TGTATGACCGATGCATTCTGTGGTAAGATC
GCGGAGACAGCACACCGGAAGACAAGAGTG|GGCTTACCATATGAGCCCAGGATGCTCTTG
CTGGTGCGACGTTACACTGGGGGCTTACCA|AGTTACACTGGGGGCTTACCATATGAGCCC
GCCTAATGTTACGTCAAGAGAGTGGACACA|ATGGTCCGAGACGCCTGGTGCGACGTTACA
TCATAAAGGCTGTAACCGCGTCAGAGTTAC|CCTGAAACCATGACAGCCACTAATGTTATT
ACGCCTGGTGCGACGTTACACTGGGGGCTT|GCCCAGTTACACTGGGGGCTTACCATATGA
GGCGTGCGCTGCGGTGGGCGGAAAGTACAA|ACCATATGAGCCCATGGGGGCTTACCATAT
TGAGCCCAGAATCTCGTGTTTCGCTATAAT|CCCGTCAAATTGTGCAAGTAGATCTATGCT
TGGGGGCTTACCATATGAGCCCATGGGGGC|CTGGCTATATGTATGACCGATGCATTCTGT
CGTCAAGAGAGTGGACACAGGCTGAGCTCA|CGCCTGGTGCGACGTTACACTGGGGGCTTA
AGTAACCATCTCGTTACACTGGGGGCTTAC|AGCAAAGCTAAAGGCTCCCTTGGTTACACT
TGAGCCCACTGTCCAAGTCAGGGTTCGGAT|GTTACACTGGGGGCTTACCATATGAGCCCA
TAGGCATCCCAAGTGGTTTCATAAAGGCTG|CGGCGGCTCGCGGGACTTCCTGAAACCATG
TGCGCTGCGGTGGGCGGAAAGTACAACGAG|TATGAGCCCATGGGGGCTTACCATATGAGC
TGCAAGTAGATCTATGCTAGGTGGGCGTCA|ATAACCGGTATGTAGACGTTAGGCATCCCA
CACTTCCCGTCTCCCTAAGTGTAGTTTGAA|AAAAACAAAAGAAACATGTCCAATGATTAG
TTACGGGACCGACGAGCAAAGCTAAAGGCT|CCCCGTTCGTATTTCTTAGTTTCCATGGCC
TTGTGATCAGGCTGAGCTCCTGAATCACCT|GCTTACCATATGAGCCCACTGTCCAAGTCA
TAAGGTGCACAAAAATCCTCGAAGTAACCA|CCCAGCGGTTACGGGACCGACGAGCAAAGC
ATATGAGCCCATGGGGGCTTACCATATGAG|ATGACCGATGCATTCTGTGGTAAGATCCCG
CAAGTGGTTTCATAAAGGCTGTAACCGCGT|GCGGGACTTCCTGAAACCATGACAGCCACT
CAGCGCTAACCATCGTTACACTGGGGGCTT|CTATCCGGCCTAATGTTACGTCAAGAGAGT
TTACCATATGAGCCCAGGGTCCGAATCAAG|CACTGGGGGCTTACCATGTTACACTGGGGG
TAAAGGCTCCCTTGGTTACACTGGGGGCTT|CCATGGCCAGCTACTACGATCGAGGGAGGA
ATGAGCCCATGGGGGCTTACCATATGAGCC|GACCGATGCATTCTGTGGTAAGATCCCGTC
TTCCATGGCCAGCTACTACGATCGAGGGAG|GGGCTTACCATATGAGCCCAGGCGTGCGCT
CTATGCTAGGTGGGCGTCATTGGCCGCTCG|GTAGACGTTAGGCATCCCAAGTGGTTTCAT
TCCCTTGGTTACACTGGGGGCTTACCATGT|CAGCTACTACGATCGAGGGAGGAAGCTTCG
CGTCAAATTGTGCAAGTAGATCTATGCTAG|AAAGTATAGGATAACCGGTATGTAGACGTT
ACACTGGGGGCTTACCATATGAGCCCAGGG|TCCCTTGGTTACACTGGGGGCTTACCATGT
TTCGTATTTCTTAGTTTCCATGGCCAGCTA|ATAGGGTTACACTGGGGGCTTACCATATGA
ACTACGATCGAGGGAGGAAGCTTCGTAGCG|AGCCCAGGCGTGCGCTGCGGTGGGCGGAAA
ACCGGAAGACAAGAGTGATCACTGGTAAAT|AGCCCAGGATGCTCTTGAAATCCCCGCCAC
CGCAAAACCCTGAACGTAAAGTATAGGATA|CCGTTACACTGGGGGCTTACCATATGAGCC
GTTACACTGGGGGCTTACCATATGAGCCCA|GGCTCCCTTGGTTACACTGGGGGCTTACCA
AACCGCCTGTTGTGATCAGGCTGAGCTCCT|ACACTGGGGGCTTACCATATGAGCCCACTG
CCGATGCATTCTGTGGTAAGATCCCGTCAA|GCATTCTCGCAAAACCCTGAACGTAAAGTA
GGGGCTTACCATATGAGCCCAAAAACAAAA|CCTCGAAGTAACCATCTCGTTACACTGGGG
TCTGATGAGTAATAGAACCGCCTGTTGTGA|CATTGGCCGCTCGTTACACTGGGGGCTTAC
GGGCTTACCATATGAGCCCAGCGGTTACGG|ATATGAGCCCAATGAGCCCATCGTCCCCGT
CCCAAGTGGTTTCATAAAGGCTGTAACCGC|TCGCGGGACTTCCTGAAACCATGACAGCCA
CGATAAACCCTATTCAGTTACACTGGGGGC|CTGGGGGTATAAGGTGCACAAAAATCCTCG
ATCCCGTCAAATTGTGCAAGTAGATCTATG|ACGTAAAGTATAGGATAACCGGTATGTAGA
GACGTTAGGCATCCCAAGTGGTTTCATAAA|GACGGCGGCGGCTCGCGGGACTTCCTGAAA
TGTTGTGATCAGGCTGAGCTCCTGAATCAC|GGGCTTACCATATGAGCCCACTGTCCAAGT
CACTGGGGGCTTACCATATGAGCCCAGTTA|GCGGCGAGCGGATTCTCGCTTATGTGCGGA
TAACCATCTCGTTACACTGGGGGCTTACCA|CAAAGCTAAAGGCTCCCTTGGTTACACTGG
GGAAGACAAGAGTGATCACTGGTAAATAGG|CCAGGATGCTCTTGAAATCCCCGCCACTAC
ATTCAGTTACACTGGGGGCTTACCATATGA|AGGTGCACAAAAATCCTCGAAGTAACCATC
GTGGTAAGATCCCGTCAAATTGTGCAAGTA|AACCCTGAACGTAAAGTATAGGATAACCGG
ACACCCCAGCGTCGCACTTCCCGTCTCCCT|TACCATATGAGCCCAAAAACAAAAGAAACA
GCATATGCGTTACACTGGGGGCTTACCATA|CAGAATCTCGTGTTTCGCTATAATAGACAA
TATGAGCCCAGCGGTTACGGGACCGACGAG|AATGAGCCCATCGTCCCCGTTCGTATTTCT
TCTCGTTACACTGGGGGCTTACCATATGAG|TAAAGGCTCCCTTGGTTACACTGGGGGCTT
CAGAGTTACACTGGGGGCTTACCATATGAG|AATGTTATTTCTCGCGCAGCCGGTTGACTG
TGATCAGGCTGAGCTCCTGAATCACCTGGC|TACCATATGAGCCCACTGTCCAAGTCAGGG
GTAAAGTATAGGATAACCGGTATGTAGACG|CTTACCATATGAGCCCAGGATCAGGGGACG
ACGGGACCGACGAGCAAAGCTAAAGGCTCC|CCGTTCGTATTTCTTAGTTTCCATGGCCAG
CAGGGTTCGGATGTCGGCATTCTCGCAAAA|CATATGAGCCCAGCATATACACGCCGTTAC
TACCATATGAGCCCATTACTAAAGGGCCAC|AGGAACGATAAACCCTATTCAGTTACACTG
GCCCAGGAACGATAAACCCTATTCAGTTAC|CTGAGCTCACTGGGGGTATAAGGTGCACAA
GCTTACCATATGAGCCCAGGCGTGCGCTGC|ACGTTACACTGGGGGCTTACCATATGAGCC
CATTGGCCGCTCGTTACACTGGGGGCTTAC|CAAGTGGTTTCATAAAGGCTGTAACCGCGT
ACAAAAATCCTCGAAGTAACCATCTCGTTA|TTACGGGACCGACGAGCAAAGCTAAAGGCT
TACACGTTACACTGGGGGCTTACCATATGA|CTCCTGAATCACCTGGCTATATGTATGACC
CACGCCGTTACACTGGGGGCTTACCATATG|TGGGAGAGATATTGTTCCGCTTCGACACAG
GTGCGACGTTACACTGGGGGCTTACCATAT|TACACTGGGGGCTTACCATATGAGCCCAAT
TGAATCACCTGGCTATATGTATGACCGATG|GTCCAAGTCAGGGTTCGGATGTCGGCATTC
GGGCTTACCATATGAGCCCAGGAACGATAA|GAGAGTGGACACAGGCTGAGCTCACTGGGG
GGGCTTACCATATGAGCCCAGGCGTGCGCT|ACACGTTACACTGGGGGCTTACCATATGAG
CTGGGGGCTTACCATATGAGCCCAGGATGC|TCGCTATAATAGACAATGGCTCTGATGAGT
CGTATTTCTTAGTTTCCATGGCCAGCTACT|AGGGTTACACTGGGGGCTTACCATATGAGC
CCCACTGTCCAAGTCAGGGTTCGGATGTCG|CACTGGGGGCTTACCATATGAGCCCAGCAT
TTCGTAGCGGCGAGCGGATTCTCGCTTATG|GGGCGGAAAGTACAACGAGCGCATATGCGT
ATTGGCGGAGACAGCACACCGGAAGACAAG|TGGGGGCTTACCATATGAGCCCAGGATGCT
CGCCTGGTGCGACGTTACACTGGGGGCTTA|CCCAGTTACACTGGGGGCTTACCATATGAG
CCCCAGCGTCGCACTTCCCGTCTCCCTAAG|CATATGAGCCCAAAAACAAAAGAAACATGT
ACACTGGGGGCTTACCATATGAGCCCAGGA|ACGTCAAGAGAGTGGACACAGGCTGAGCTC
GTCCACACCCCAGCGTCGCACTTCCCGTCT|GGCTTACCATATGAGCCCAAAAACAAAAGA
ATACAGTAACCTATATACGCCCACATAGGG|CACCAGCGCTAACCATCGTTACACTGGGGG
ATGAGCCCATCGTCCCCGTTCGTATTTCTT|AAGAGTGATCACTGGTAAATAGGGTTACAC
ATCTCGTTACACTGGGGGCTTACCATATGA|CTAAAGGCTCCCTTGGTTACACTGGGGGCT
CGTGCGCTGCGGTGGGCGGAAAGTACAACG|CATATGAGCCCATGGGGGCTTACCATATGA
GCCCAGGATGCTCTTGAAATCCCCGCCACT|CTCTGATGAGTAATAGAACCGCCTGTTGTG
GTTACACTGGGGGCTTACCATATGAGCCCA|GTTACGTCAAGAGAGTGGACACAGGCTGAG
ACCATATGAGCCCAAAAACAAAAGAAACAT|GTAACCATCTCGTTACACTGGGGGCTTACC
TGTGATCAGGCTGAGCTCCTGAATCACCTG|CTTACCATATGAGCCCACTGTCCAAGTCAG
TACACTGGGGGCTTACCATATGAGCCCATG|ATCACCTGGCTATATGTATGACCGATGCAT
GACCGATGCATTCTGTGGTAAGATCCCGTC|CGGCATTCTCGCAAAACCCTGAACGTAAAG
CCGACGAGCAAAGCTAAAGGCTCCCTTGGT|GTATTTCTTAGTTTCCATGGCCAGCTACTA
AAGAAACATGTCCAATGATTAGGTGGGGAC|GGGCTTACCATATGAGCCCAGGGTCCGAAT
CGCACTTCCCGTCTCCCTAAGTGTAGTTTG|CCAAAAACAAAAGAAACATGTCCAATGATT
TGAGCCCAGCGGTTACGGGACCGACGAGCA|TGAGCCCATCGTCCCCGTTCGTATTTCTTA
ACCATATGAGCCCAGCGGTTACGGGACCGA|GCCCAATGAGCCCATCGTCCCCGTTCGTAT
CACTACAGTACACGTTACACGTTACACTGG|TGTGATCAGGCTGAGCTCCTGAATCACCTG
CCATATGAGCCCAGGGTCCGAATCAAGGAA|TGGGGGCTTACCATGTTACACTGGGGGCTT
AATAGACAATGGCTCTGATGAGTAATAGAA|GCTAGGTGGGCGTCATTGGCCGCTCGTTAC
TATGACCGATGCATTCTGTGGTAAGATCCC|TGTCGGCATTCTCGCAAAACCCTGAACGTA
TTACACTGGGGGCTTACCATATGAGCCCAG|TATTTCTCGCGCAGCCGGTTGACTGTAACC
CTGGGGGCTTACCATATGAGCCCATGGGGG|CCTGGCTATATGTATGACCGATGCATTCTG
TCCACACCCCAGCGTCGCACTTCCCGTCTC|GCTTACCATATGAGCCCAAAAACAAAAGAA
TGAGCTCACTGGGGGTATAAGGTGCACAAA|GGGGCTTACCATATGAGCCCAGCGGTTACG
CACTGGGGGCTTACCATATGAGCCCATTAC|CATATGAGCCCAGGAACGATAAACCCTATT
CGGCCTAATGTTACGTCAAGAGAGTGGACA|GAATGGTCCGAGACGCCTGGTGCGACGTTA
CAGCGTCGCACTTCCCGTCTCCCTAAGTGT|ATGAGCCCAAAAACAAAAGAAACATGTCCA
ACTGGGGGTATAAGGTGCACAAAAATCCTC|ACCATATGAGCCCAGCGGTTACGGGACCGA
GAGCTCCTGAATCACCTGGCTATATGTATG|GCCCACTGTCCAAGTCAGGGTTCGGATGTC
CGGGACCGACGAGCAAAGCTAAAGGCTCCC|CGTTCGTATTTCTTAGTTTCCATGGCCAGC
ACAGTAACCTATATACGCCCACATAGGGAG|CCAGCGCTAACCATCGTTACACTGGGGGCT
CACCGGAAGACAAGAGTGATCACTGGTAAA|GAGCCCAGGATGCTCTTGAAATCCCCGCCA
TTCCCGTCTCCCTAAGTGTAGTTTGAATGT|AACAAAAGAAACATGTCCAATGATTAGGTG
CCCAGTTACACTGGGGGCTTACCATATGAG|TGTGCGGATTGGCGGAGACAGCACACCGGA
TGGGGGCTTACCATGTTACACTGGGGGCTT|GAGGGAGGAAGCTTCGTAGCGGCGAGCGGA
GGGGGCTTACCATATGAGCCCAGAATCTCG|TTCTGTGGTAAGATCCCGTCAAATTGTGCA
GGCGGAGACAGCACACCGGAAGACAAGAGT|GGGCTTACCATATGAGCCCAGGATGCTCTT
GATAAACCCTATTCAGTTACACTGGGGGCT|TGGGGGTATAAGGTGCACAAAAATCCTCGA
AGCTACTACGATCGAGGGAGGAAGCTTCGT|TATGAGCCCAGGCGTGCGCTGCGGTGGGCG
CCTGGCTATATGTATGACCGATGCATTCTG|TCAGGGTTCGGATGTCGGCATTCTCGCAAA
TACACCAGCGCTAACCATCGTTACACTGGG|GGGGACTATCCGGCCTAATGTTACGTCAAG
TCCCCGCCACTACAGTACACGTTACACGTT|CGCCTGTTGTGATCAGGCTGAGCTCCTGAA
CTGAGCTCCTGAATCACCTGGCTATATGTA|GAGCCCACTGTCCAAGTCAGGGTTCGGATG
GCTGCGGTGGGCGGAAAGTACAACGAGCGC|GAGCCCATGGGGGCTTACCATATGAGCCCA
GGGGTATAAGGTGCACAAAAATCCTCGAAG|TATGAGCCCAGCGGTTACGGGACCGACGAG
AGGAATGGTCCGAGACGCCTGGTGCGACGT|GGCTTACCATATGAGCCCAGTTACACTGGG
TGAGCCCAGGATGCTCTTGAAATCCCCGCC|TGGCTCTGATGAGTAATAGAACCGCCTGTT
GACCGACGAGCAAAGCTAAAGGCTCCCTTG|TCGTATTTCTTAGTTTCCATGGCCAGCTAC
GGCTCCCTTGGTTACACTGGGGGCTTACCA|GGCCAGCTACTACGATCGAGGGAGGAAGCT
GTCCGAATCAAGGAATGGTCCGAGACGCCT|TTACACTGGGGGCTTACCATATGAGCCCAG
GTTACGGGACCGACGAGCAAAGCTAAAGGC|TCCCCGTTCGTATTTCTTAGTTTCCATGGC
TCTCCCTAAGTGTAGTTTGAATGTACACCA|AGAAACATGTCCAATGATTAGGTGGGGACT
AGAAACATGTCCAATGATTAGGTGGGGACT|GGCTTACCATATGAGCCCAGGGTCCGAATC
AGCGTCGCACTTCCCGTCTCCCTAAGTGTA|TGAGCCCAAAAACAAAAGAAACATGTCCAA
TCAAATTGTGCAAGTAGATCTATGCTAGGT|AGTATAGGATAACCGGTATGTAGACGTTAG
CAGTTACACTGGGGGCTTACCATATGAGCC|TGCGGATTGGCGGAGACAGCACACCGGAAG
ATGAGCCCAGGCGTGCGCTGCGGTGGGCGG|TGGGGGCTTACCATATGAGCCCATGGGGGC
TGTTACGTCAAGAGAGTGGACACAGGCTGA|CGAGACGCCTGGTGCGACGTTACACTGGGG
TCGTTACACTGGGGGCTTACCATATGAGCC|ATGTTACGTCAAGAGAGTGGACACAGGCTG
ACGAGCAAAGCTAAAGGCTCCCTTGGTTAC|TTTCTTAGTTTCCATGGCCAGCTACTACGA
CTTACCATATGAGCCCAGGCGTGCGCTGCG|CGTTACACTGGGGGCTTACCATATGAGCCC
GTTTCGCTATAATAGACAATGGCTCTGATG|GTAGATCTATGCTAGGTGGGCGTCATTGGC
AGCAAAGCTAAAGGCTCCCTTGGTTACACT|CTTAGTTTCCATGGCCAGCTACTACGATCG
ACCCTATTCAGTTACACTGGGGGCTTACCA|GTATAAGGTGCACAAAAATCCTCGAAGTAA
GCGGTTACGGGACCGACGAGCAAAGCTAAA|TCGTCCCCGTTCGTATTTCTTAGTTTCCAT
CGTGTTTCGCTATAATAGACAATGGCTCTG|CAAGTAGATCTATGCTAGGTGGGCGTCATT
TACACTGGGGGCTTACCATATGAGCCCAGG|TACACGTTACACGTTACACTGGGGGCTTAC
ATGTTACACTGGGGGCTTACCATATGAGCC|TTCGTAGCGGCGAGCGGATTCTCGCTTATG
CCACATAGGGAGTTACACTGGGGGCTTACC|ACACTGGGGGCTTACCATATGAGCCCAGGA
CCGTCAAATTGTGCAAGTAGATCTATGCTA|TAAAGTATAGGATAACCGGTATGTAGACGT
CTATTCAGTTACACTGGGGGCTTACCATAT|TAAGGTGCACAAAAATCCTCGAAGTAACCA
AAGGCTGTAACCGCGTCAGAGTTACACTGG|AACCATGACAGCCACTAATGTTATTTCTCG
CTGAGCTCACTGGGGGTATAAGGTGCACAA|GGGGGCTTACCATATGAGCCCAGCGGTTAC
GAATCAAGGAATGGTCCGAGACGCCTGGTG|ACTGGGGGCTTACCATATGAGCCCAGTTAC
CCACACCCCAGCGTCGCACTTCCCGTCTCC|CTTACCATATGAGCCCAAAAACAAAAGAAA
ATAGGGAGTTACACTGGGGGCTTACCATAT|TGGGGGCTTACCATATGAGCCCAGGAACGA
GGGGCTTACCATATGAGCCCAGGGTCCGAA|GGTTACACTGGGGGCTTACCATGTTACACT
GTCAAGAGAGTGGACACAGGCTGAGCTCAC|GCCTGGTGCGACGTTACACTGGGGGCTTAC
GTTACACTGGGGGCTTACCATATGAGCCCA|TAAAGGCTGTAACCGCGTCAGAGTTACACT
GCTTACCATATGAGCCCAGTTACACTGGGG|CGGATTCTCGCTTATGTGCGGATTGGCGGA
CATATGAGCCCAAAAACAAAAGAAACATGT|AACCATCTCGTTACACTGGGGGCTTACCAT
GGCGGAAAGTACAACGAGCGCATATGCGTT|GGGGCTTACCATATGAGCCCAGAATCTCGT
TATGAGCCCAGGAACGATAAACCCTATTCA|ACAGGCTGAGCTCACTGGGGGTATAAGGTG
CCGCGTCAGAGTTACACTGGGGGCTTACCA|GCCACTAATGTTATTTCTCGCGCAGCCGGT
ATACGCCCACATAGGGAGTTACACTGGGGG|ATCGTTACACTGGGGGCTTACCATATGAGC
ATCTCGTGTTTCGCTATAATAGACAATGGC|TGTGCAAGTAGATCTATGCTAGGTGGGCGT
TGGGCGGAAAGTACAACGAGCGCATATGCG|TGGGGGCTTACCATATGAGCCCAGAATCTC
TTACACTGGGGGCTTACCATATGAGCCCAC|AAAGGCTGTAACCGCGTCAGAGTTACACTG
GGTGGGCGGAAAGTACAACGAGCGCATATG|CATGGGGGCTTACCATATGAGCCCAGAATC
CGTTACACTGGGGGCTTACCATATGAGCCC|GGGGGCTTACCATATGAGCCCAATGAGCCC
AAAGTACAACGAGCGCATATGCGTTACACT|TTACCATATGAGCCCAGAATCTCGTGTTTC
GGTTTCATAAAGGCTGTAACCGCGTCAGAG|ACTTCCTGAAACCATGACAGCCACTAATGT
AGGAAGCTTCGTAGCGGCGAGCGGATTCTC|CTGCGGTGGGCGGAAAGTACAACGAGCGCA
GGGGCTTACCATATGAGCCCAGTTACACTG|GAGCGGATTCTCGCTTATGTGCGGATTGGC
TACCATATGAGCCCAGCATATACACGCCGT|CCGGTTGACTGTAACCAGAGAGTGGGAGAG
GTAGTTTGAATGTACACCAGCGCTAACCAT|CAATGATTAGGTGGGGACTATCCGGCCTAA
GAGCCCATCGTCCCCGTTCGTATTTCTTAG|GAGTGATCACTGGTAAATAGGGTTACACTG
CCATATGAGCCCAGAATCTCGTGTTTCGCT|AAGATCCCGTCAAATTGTGCAAGTAGATCT
AGCCCAGCATATACACGCCGTTACACTGGG|TGTAACCAGAGAGTGGGAGAGATATTGTTC
CCATATGAGCCCATGGGGGCTTACCATATG|GTATGACCGATGCATTCTGTGGTAAGATCC
TGAGTAATAGAACCGCCTGTTGTGATCAGG|GCCGCTCGTTACACTGGGGGCTTACCATAT
CCTAATGTTACGTCAAGAGAGTGGACACAG|TGGTCCGAGACGCCTGGTGCGACGTTACAC
ATTGTGCAAGTAGATCTATGCTAGGTGGGC|TAGGATAACCGGTATGTAGACGTTAGGCAT
ACCGATGCATTCTGTGGTAAGATCCCGTCA|GGCATTCTCGCAAAACCCTGAACGTAAAGT
TGGGGGCTTACCATATGAGCCCAGGCGTGC|GTTACACGTTACACTGGGGGCTTACCATAT
CTCTGATGAGTAATAGAACCGCCTGTTGTG|TCATTGGCCGCTCGTTACACTGGGGGCTTA
ATGTACACCAGCGCTAACCATCGTTACACT|GGTGGGGACTATCCGGCCTAATGTTACGTC
ATATGAGCCCAGGATGCTCTTGAAATCCCC|CAATGGCTCTGATGAGTAATAGAACCGCCT
AGCCCAGGGTCCGAATCAAGGAATGGTCCG|TTACCATGTTACACTGGGGGCTTACCATAT
TGGGGGCTTACCATATGAGCCCATTACTAA|ATGAGCCCAGGAACGATAAACCCTATTCAG
GAAGCTTCGTAGCGGCGAGCGGATTCTCGC|GCGGTGGGCGGAAAGTACAACGAGCGCATA
CGCTCGTTACACTGGGGGCTTACCATATGA|TTTCATAAAGGCTGTAACCGCGTCAGAGTT
AAAGAAACATGTCCAATGATTAGGTGGGGA|GGGGCTTACCATATGAGCCCAGGGTCCGAA
ATGGTCCGAGACGCCTGGTGCGACGTTACA|TACCATATGAGCCCAGTTACACTGGGGGCT
GCCCAGGCGTGCGCTGCGGTGGGCGGAAAG|GGCTTACCATATGAGCCCATGGGGGCTTAC
CAGCACACCGGAAGACAAGAGTGATCACTG|CATATGAGCCCAGGATGCTCTTGAAATCCC
GGGGCTTACCATATGAGCCCAGCGGTTACG|CATATGAGCCCAATGAGCCCATCGTCCCCG
AGCCCAGGCGTGCGCTGCGGTGGGCGGAAA|GGGCTTACCATATGAGCCCATGGGGGCTTA
CATATGAGCCCAGGATGCTCTTGAAATCCC|ACAATGGCTCTGATGAGTAATAGAACCGCC
ACCGGTATGTAGACGTTAGGCATCCCAAGT|CAGGATCAGGGGACGGCGGCGGCTCGCGGG
CTTACCATATGAGCCCAGTTACACTGGGGG|GGATTCTCGCTTATGTGCGGATTGGCGGAG
CTGGGGGCTTACCATATGAGCCCATTACTA|TATGAGCCCAGGAACGATAAACCCTATTCA
CTGGTAAATAGGGTTACACTGGGGGCTTAC|CCCCGCCACTACAGTACACGTTACACGTTA
GTTACGTCAAGAGAGTGGACACAGGCTGAG|GAGACGCCTGGTGCGACGTTACACTGGGGG
GATTCTCGCTTATGTGCGGATTGGCGGAGA|GAGCGCATATGCGTTACACTGGGGGCTTAC
GGCCAGCTACTACGATCGAGGGAGGAAGCT|ACCATATGAGCCCAGGCGTGCGCTGCGGTG
CCACGTGTCCACACCCCAGCGTCGCACTTC|ACTGGGGGCTTACCATATGAGCCCAAAAAC
CCAGGAACGATAAACCCTATTCAGTTACAC|GAGCTCACTGGGGGTATAAGGTGCACAAAA
GGATGCTCTTGAAATCCCCGCCACTACAGT|ATGAGTAATAGAACCGCCTGTTGTGATCAG
ACTGGGGGCTTACCATATGAGCCCAGCGGT|TTACCATATGAGCCCAATGAGCCCATCGTC
GGTATGTAGACGTTAGGCATCCCAAGTGGT|GATCAGGGGACGGCGGCGGCTCGCGGGACT
GGACTATCCGGCCTAATGTTACGTCAAGAG|GAATCAAGGAATGGTCCGAGACGCCTGGTG
TATGAGCCCAGAATCTCGTGTTTCGCTATA|ATCCCGTCAAATTGTGCAAGTAGATCTATG
CCCGCCACTACAGTACACGTTACACGTTAC|CCTGTTGTGATCAGGCTGAGCTCCTGAATC
GGTGCGACGTTACACTGGGGGCTTACCATA|TTACACTGGGGGCTTACCATATGAGCCCAA
TCCCGTCAAATTGTGCAAGTAGATCTATGC|CGTAAAGTATAGGATAACCGGTATGTAGAC
TACACTGGGGGCTTACCATATGAGCCCAGG|CTCCCTTGGTTACACTGGGGGCTTACCATG
AGACGTTAGGCATCCCAAGTGGTTTCATAA|GGACGGCGGCGGCTCGCGGGACTTCCTGAA
TCAAGGAATGGTCCGAGACGCCTGGTGCGA|GGGGGCTTACCATATGAGCCCAGTTACACT
CGGATTCTCGCTTATGTGCGGATTGGCGGA|ACGAGCGCATATGCGTTACACTGGGGGCTT
CCATCTCGTTACACTGGGGGCTTACCATAT|AGCTAAAGGCTCCCTTGGTTACACTGGGGG
GCATATACACGCCGTTACACTGGGGGCTTA|CAGAGAGTGGGAGAGATATTGTTCCGCTTC
AAACCCTATTCAGTTACACTGGGGGCTTAC|GGGTATAAGGTGCACAAAAATCCTCGAAGT
CTCGTTACACTGGGGGCTTACCATATGAGC|AAAGGCTCCCTTGGTTACACTGGGGGCTTA
CATAGGGAGTTACACTGGGGGCTTACCATA|CTGGGGGCTTACCATATGAGCCCAGGAACG
CCATATGAGCCCAATGAGCCCATCGTCCCC|CACACCGGAAGACAAGAGTGATCACTGGTA
CCTGAACGTAAAGTATAGGATAACCGGTAT|CTGGGGGCTTACCATATGAGCCCAGGATCA
GCTTACCATATGAGCCCAGAATCTCGTGTT|GTGGTAAGATCCCGTCAAATTGTGCAAGTA
AGCCCAGGATGCTCTTGAAATCCCCGCCAC|GCTCTGATGAGTAATAGAACCGCCTGTTGT
GTGGACACAGGCTGAGCTCACTGGGGGTAT|GACGTTACACTGGGGGCTTACCATATGAGC
GTATTTCTTAGTTTCCATGGCCAGCTACTA|GGGTTACACTGGGGGCTTACCATATGAGCC
CTCGCTTATGTGCGGATTGGCGGAGACAGC|GCATATGCGTTACACTGGGGGCTTACCATA
GTAGCGGCGAGCGGATTCTCGCTTATGTGC|CGGAAAGTACAACGAGCGCATATGCGTTAC
GAGTTACACTGGGGGCTTACCATATGAGCC|GCTTACCATATGAGCCCAGGAACGATAAAC
AAAAATCCTCGAAGTAACCATCTCGTTACA|ACGGGACCGACGAGCAAAGCTAAAGGCTCC
ATAAACCCTATTCAGTTACACTGGGGGCTT|GGGGGTATAAGGTGCACAAAAATCCTCGAA
CTTCGTAGCGGCGAGCGGATTCTCGCTTAT|TGGGCGGAAAGTACAACGAGCGCATATGCG
CCAGTTACACTGGGGGCTTACCATATGAGC|GTGCGGATTGGCGGAGACAGCACACCGGAA
TGATCACTGGTAAATAGGGTTACACTGGGG|TGAAATCCCCGCCACTACAGTACACGTTAC
GGGACTATCCGGCCTAATGTTACGTCAAGA|CGAATCAAGGAATGGTCCGAGACGCCTGGT
CGATCGAGGGAGGAAGCTTCGTAGCGGCGA|CAGGCGTGCGCTGCGGTGGGCGGAAAGTAC
GTATAAGGTGCACAAAAATCCTCGAAGTAA|GAGCCCAGCGGTTACGGGACCGACGAGCAA
CTGTAACCGCGTCAGAGTTACACTGGGGGC|ATGACAGCCACTAATGTTATTTCTCGCGCA
ACACAGGCTGAGCTCACTGGGGGTATAAGG|TTACACTGGGGGCTTACCATATGAGCCCAG
TGTGCGGATTGGCGGAGACAGCACACCGGA|GTTACACTGGGGGCTTACCATATGAGCCCA
ATATGAGCCCATTACTAAAGGGCCACGTGT|ACGATAAACCCTATTCAGTTACACTGGGGG
TGCATTCTGTGGTAAGATCCCGTCAAATTG|TCTCGCAAAACCCTGAACGTAAAGTATAGG
TGCTAGGTGGGCGTCATTGGCCGCTCGTTA|GACGTTAGGCATCCCAAGTGGTTTCATAAA
GTGATCAGGCTGAGCTCCTGAATCACCTGG|TTACCATATGAGCCCACTGTCCAAGTCAGG
CATAAAGGCTGTAACCGCGTCAGAGTTACA|CTGAAACCATGACAGCCACTAATGTTATTT
ACGTTACACGTTACACTGGGGGCTTACCAT|TGAGCTCCTGAATCACCTGGCTATATGTAT
CCAGGCGTGCGCTGCGGTGGGCGGAAAGTA|CTTACCATATGAGCCCATGGGGGCTTACCA
GCGTCAGAGTTACACTGGGGGCTTACCATA|CACTAATGTTATTTCTCGCGCAGCCGGTTG
TAGTTTCCATGGCCAGCTACTACGATCGAG|CTGGGGGCTTACCATATGAGCCCAGGCGTG
CACGTTACACTGGGGGCTTACCATATGAGC|CCTGAATCACCTGGCTATATGTATGACCGA
GACGAGCAAAGCTAAAGGCTCCCTTGGTTA|ATTTCTTAGTTTCCATGGCCAGCTACTACG
CTTGAAATCCCCGCCACTACAGTACACGTT|ATAGAACCGCCTGTTGTGATCAGGCTGAGC
GTGGTTTCATAAAGGCTGTAACCGCGTCAG|GGACTTCCTGAAACCATGACAGCCACTAAT
GCTTACCATATGAGCCCAGGAACGATAAAC|GAGTGGACACAGGCTGAGCTCACTGGGGGT
TAGAACCGCCTGTTGTGATCAGGCTGAGCT|GTTACACTGGGGGCTTACCATATGAGCCCA
CTCTTGAAATCCCCGCCACTACAGTACACG|TAATAGAACCGCCTGTTGTGATCAGGCTGA
CAATGGCTCTGATGAGTAATAGAACCGCCT|TGGGCGTCATTGGCCGCTCGTTACACTGGG
TTGAATGTACACCAGCGCTAACCATCGTTA|ATTAGGTGGGGACTATCCGGCCTAATGTTA
GGGGGCTTACCATATGAGCCCAGCATATAC|CGCGCAGCCGGTTGACTGTAACCAGAGAGT
AGGGTTACACTGGGGGCTTACCATATGAGC|TACAGTACACGTTACACGTTACACTGGGGG
ACACCGGAAGACAAGAGTGATCACTGGTAA|TGAGCCCAGGATGCTCTTGAAATCCCCGCC
AAGGCTCCCTTGGTTACACTGGGGGCTTAC|ATGGCCAGCTACTACGATCGAGGGAGGAAG
CATATGAGCCCAATGAGCCCATCGTCCCCG|ACACCGGAAGACAAGAGTGATCACTGGTAA
TGGGGACTATCCGGCCTAATGTTACGTCAA|TCCGAATCAAGGAATGGTCCGAGACGCCTG
TACACTGGGGGCTTACCATATGAGCCCAGG|TGTTTCGCTATAATAGACAATGGCTCTGAT
CAAAAGAAACATGTCCAATGATTAGGTGGG|TGGGGGCTTACCATATGAGCCCAGGGTCCG
TGAGCCCAAAAACAAAAGAAACATGTCCAA|ATCTCGTTACACTGGGGGCTTACCATATGA
AAACATGTCCAATGATTAGGTGGGGACTAT|CTTACCATATGAGCCCAGGGTCCGAATCAA
GGCATCCCAAGTGGTTTCATAAAGGCTGTA|GCGGCTCGCGGGACTTCCTGAAACCATGAC
ACCATCTCGTTACACTGGGGGCTTACCATA|AAGCTAAAGGCTCCCTTGGTTACACTGGGG
GAGCCCACTGTCCAAGTCAGGGTTCGGATG|TTACACTGGGGGCTTACCATATGAGCCCAG
CAACGAGCGCATATGCGTTACACTGGGGGC|TATGAGCCCAGAATCTCGTGTTTCGCTATA
ATGTATGACCGATGCATTCTGTGGTAAGAT|GGATGTCGGCATTCTCGCAAAACCCTGAAC
GTAACCATCTCGTTACACTGGGGGCTTACC|GCAAAGCTAAAGGCTCCCTTGGTTACACTG
ACAACGAGCGCATATGCGTTACACTGGGGG|ATATGAGCCCAGAATCTCGTGTTTCGCTAT
TTCGCTATAATAGACAATGGCTCTGATGAG|AGATCTATGCTAGGTGGGCGTCATTGGCCG
ACACGTTACACTGGGGGCTTACCATATGAG|TCCTGAATCACCTGGCTATATGTATGACCG
TGGGGGCTTACCATATGAGCCCAAAAACAA|ATCCTCGAAGTAACCATCTCGTTACACTGG
ACACGTTACACGTTACACTGGGGGCTTACC|GCTGAGCTCCTGAATCACCTGGCTATATGT
ACACTGGGGGCTTACCATATGAGCCCATGG|TCACCTGGCTATATGTATGACCGATGCATT
AAGTACAACGAGCGCATATGCGTTACACTG|TACCATATGAGCCCAGAATCTCGTGTTTCG
TGGGGGCTTACCATATGAGCCCAGTTACAC|GCGAGCGGATTCTCGCTTATGTGCGGATTG
TAGATCTATGCTAGGTGGGCGTCATTGGCC|GGTATGTAGACGTTAGGCATCCCAAGTGGT
AAAAACAAAAGAAACATGTCCAATGATTAG|TACACTGGGGGCTTACCATATGAGCCCAGG
CATGGGGGCTTACCATATGAGCCCAGAATC|GCATTCTGTGGTAAGATCCCGTCAAATTGT
TTACACTGGGGGCTTACCATATGAGCCCAA|GGATTGGCGGAGACAGCACACCGGAAGACA
ATGGCTCTGATGAGTAATAGAACCGCCTGT|GGCGTCATTGGCCGCTCGTTACACTGGGGG
GTTTCCATGGCCAGCTACTACGATCGAGGG|GGGGGCTTACCATATGAGCCCAGGCGTGCG
AGCGGCGAGCGGATTCTCGCTTATGTGCGG|GAAAGTACAACGAGCGCATATGCGTTACAC
TACACGTTACACGTTACACTGGGGGCTTAC|GGCTGAGCTCCTGAATCACCTGGCTATATG
AAGAGTGATCACTGGTAAATAGGGTTACAC|GCTCTTGAAATCCCCGCCACTACAGTACAC
ACTGGGGGCTTACCATGTTACACTGGGGGC|TCGAGGGAGGAAGCTTCGTAGCGGCGAGCG
GCTAACCATCGTTACACTGGGGGCTTACCA|CCGGCCTAATGTTACGTCAAGAGAGTGGAC
CCCAAAAACAAAAGAAACATGTCCAATGAT|CGTTACACTGGGGGCTTACCATATGAGCCC
ACTGGGGGCTTACCATATGAGCCCAGGGTC|CCTTGGTTACACTGGGGGCTTACCATGTTA
AAACAAAAGAAACATGTCCAATGATTAGGT|CACTGGGGGCTTACCATATGAGCCCAGGGT
CAAAACCCTGAACGTAAAGTATAGGATAAC|GTTACACTGGGGGCTTACCATATGAGCCCA
CCCAATGAGCCCATCGTCCCCGTTCGTATT|AGACAAGAGTGATCACTGGTAAATAGGGTT
CCATATGAGCCCAGGAACGATAAACCCTAT|GACACAGGCTGAGCTCACTGGGGGTATAAG
TAGGTGGGCGTCATTGGCCGCTCGTTACAC|GTTAGGCATCCCAAGTGGTTTCATAAAGGC
ATAGGATAACCGGTATGTAGACGTTAGGCA|TATGAGCCCAGGATCAGGGGACGGCGGCGG
GAACGATAAACCCTATTCAGTTACACTGGG|TCACTGGGGGTATAAGGTGCACAAAAATCC
AACCCTGAACGTAAAGTATAGGATAACCGG|ACACTGGGGGCTTACCATATGAGCCCAGGA
TTACACTGGGGGCTTACCATATGAGCCCAT|TACCATATGAGCCCAGGAACGATAAACCCT
CGCCCACATAGGGAGTTACACTGGGGGCTT|GTTACACTGGGGGCTTACCATATGAGCCCA
GTATGTAGACGTTAGGCATCCCAAGTGGTT|ATCAGGGGACGGCGGCGGCTCGCGGGACTT
TCATTGGCCGCTCGTTACACTGGGGGCTTA|CCAAGTGGTTTCATAAAGGCTGTAACCGCG
CTTACCATATGAGCCCACTGTCCAAGTCAG|CGCGTCAGAGTTACACTGGGGGCTTACCAT
CCATGGGGGCTTACCATATGAGCCCAGAAT|TGCATTCTGTGGTAAGATCCCGTCAAATTG
AATCCTCGAAGTAACCATCTCGTTACACTG|GGACCGACGAGCAAAGCTAAAGGCTCCCTT
TTACACTGGGGGCTTACCATATGAGCCCAA|ACAAAAATCCTCGAAGTAACCATCTCGTTA
TCTTAGTTTCCATGGCCAGCTACTACGATC|ACACTGGGGGCTTACCATATGAGCCCAGGC
AGTATAGGATAACCGGTATGTAGACGTTAG|CCATATGAGCCCAGGATCAGGGGACGGCGG
CCTGGTGCGACGTTACACTGGGGGCTTACC|CAGTTACACTGGGGGCTTACCATATGAGCC
GTTACACTGGGGGCTTACCATATGAGCCCA|GAATCACCTGGCTATATGTATGACCGATGC
CCGCTCGTTACACTGGGGGCTTACCATATG|GTTTCATAAAGGCTGTAACCGCGTCAGAGT
CACTGGGGGCTTACCATGTTACACTGGGGG|ATCGAGGGAGGAAGCTTCGTAGCGGCGAGC
CCAGCGCTAACCATCGTTACACTGGGGGCT|ACTATCCGGCCTAATGTTACGTCAAGAGAG
CATATACACGCCGTTACACTGGGGGCTTAC|AGAGAGTGGGAGAGATATTGTTCCGCTTCG
TAACCTATATACGCCCACATAGGGAGTTAC|CGCTAACCATCGTTACACTGGGGGCTTACC
TTTCATAAAGGCTGTAACCGCGTCAGAGTT|TTCCTGAAACCATGACAGCCACTAATGTTA
ATAGAACCGCCTGTTGTGATCAGGCTGAGC|CGTTACACTGGGGGCTTACCATATGAGCCC
ATACACGCCGTTACACTGGGGGCTTACCAT|GAGTGGGAGAGATATTGTTCCGCTTCGACA
CGACGTTACACTGGGGGCTTACCATATGAG|ACTGGGGGCTTACCATATGAGCCCAATGAG
TGTCGGCATTCTCGCAAAACCCTGAACGTA|AGCATATACACGCCGTTACACTGGGGGCTT
GCGGATTCTCGCTTATGTGCGGATTGGCGG|AACGAGCGCATATGCGTTACACTGGGGGCT
TGTAGTTTGAATGTACACCAGCGCTAACCA|CCAATGATTAGGTGGGGACTATCCGGCCTA
GCCTGTTGTGATCAGGCTGAGCTCCTGAAT|TGGGGGCTTACCATATGAGCCCACTGTCCA
GTGCAAGTAGATCTATGCTAGGTGGGCGTC|GATAACCGGTATGTAGACGTTAGGCATCCC
CAAGAGAGTGGACACAGGCTGAGCTCACTG|CTGGTGCGACGTTACACTGGGGGCTTACCA
GTCATTGGCCGCTCGTTACACTGGGGGCTT|CCCAAGTGGTTTCATAAAGGCTGTAACCGC
ATAAGGTGCACAAAAATCCTCGAAGTAACC|GCCCAGCGGTTACGGGACCGACGAGCAAAG
GGGGCTTACCATATGAGCCCAGGCGTGCGC|TACACGTTACACTGGGGGCTTACCATATGA
CTTACCATATGAGCCCAGGATGCTCTTGAA|AATAGACAATGGCTCTGATGAGTAATAGAA
CCATATGAGCCCAGGCGTGCGCTGCGGTGG|ACACTGGGGGCTTACCATATGAGCCCATGG
ACCAGCGCTAACCATCGTTACACTGGGGGC|GACTATCCGGCCTAATGTTACGTCAAGAGA
TACACTGGGGGCTTACCATATGAGCCCAGC|GGCTTACCATATGAGCCCAATGAGCCCATC
TTTGAATGTACACCAGCGCTAACCATCGTT|GATTAGGTGGGGACTATCCGGCCTAATGTT
TTAGTTTCCATGGCCAGCTACTACGATCGA|ACTGGGGGCTTACCATATGAGCCCAGGCGT
GCACACCGGAAGACAAGAGTGATCACTGGT|TATGAGCCCAGGATGCTCTTGAAATCCCCG
CACCTGGCTATATGTATGACCGATGCATTC|AGTCAGGGTTCGGATGTCGGCATTCTCGCA
ATCCCAAGTGGTTTCATAAAGGCTGTAACC|GCTCGCGGGACTTCCTGAAACCATGACAGC
ATGTTACGTCAAGAGAGTGGACACAGGCTG|CCGAGACGCCTGGTGCGACGTTACACTGGG
ACCATATGAGCCCAGGCGTGCGCTGCGGTG|TACACTGGGGGCTTACCATATGAGCCCATG
GGGGCTTACCATATGAGCCCAGCATATACA|GCGCAGCCGGTTGACTGTAACCAGAGAGTG
CTATCCGGCCTAATGTTACGTCAAGAGAGT|TCAAGGAATGGTCCGAGACGCCTGGTGCGA
TACTAAAGGGCCACGTGTCCACACCCCAGC|ATTCAGTTACACTGGGGGCTTACCATATGA
TGGGGGCTTACCATATGAGCCCAGAATCTC|ATTCTGTGGTAAGATCCCGTCAAATTGTGC
GAGCGGATTCTCGCTTATGTGCGGATTGGC|ACAACGAGCGCATATGCGTTACACTGGGGG
GGGGGCTTACCATATGAGCCCAGGAACGAT|AAGAGAGTGGACACAGGCTGAGCTCACTGG
GGCTTACCATATGAGCCCAGCATATACACG|GCAGCCGGTTGACTGTAACCAGAGAGTGGG
GGGTTCGGATGTCGGCATTCTCGCAAAACC|TATGAGCCCAGCATATACACGCCGTTACAC
CACTGGGGGCTTACCATATGAGCCCACTGT|GGCTGTAACCGCGTCAGAGTTACACTGGGG
CCACTACAGTACACGTTACACGTTACACTG|TTGTGATCAGGCTGAGCTCCTGAATCACCT
CTGATGAGTAATAGAACCGCCTGTTGTGAT|ATTGGCCGCTCGTTACACTGGGGGCTTACC
GTTTGAATGTACACCAGCGCTAACCATCGT|TGATTAGGTGGGGACTATCCGGCCTAATGT
TATGTGCGGATTGGCGGAGACAGCACACCG|GCGTTACACTGGGGGCTTACCATATGAGCC
AGTGATCACTGGTAAATAGGGTTACACTGG|CTTGAAATCCCCGCCACTACAGTACACGTT
ATGTGCGGATTGGCGGAGACAGCACACCGG|CGTTACACTGGGGGCTTACCATATGAGCCC
AACCATCGTTACACTGGGGGCTTACCATAT|GCCTAATGTTACGTCAAGAGAGTGGACACA
ACGTTACACTGGGGGCTTACCATATGAGCC|CTGAATCACCTGGCTATATGTATGACCGAT
GAGCCCAGGATGCTCTTGAAATCCCCGCCA|GGCTCTGATGAGTAATAGAACCGCCTGTTG
GTGCGCTGCGGTGGGCGGAAAGTACAACGA|ATATGAGCCCATGGGGGCTTACCATATGAG
GGTGCACAAAAATCCTCGAAGTAACCATCT|AGCGGTTACGGGACCGACGAGCAAAGCTAA
AGACAGCACACCGGAAGACAAGAGTGATCA|TACCATATGAGCCCAGGATGCTCTTGAAAT
CATCTCGTTACACTGGGGGCTTACCATATG|GCTAAAGGCTCCCTTGGTTACACTGGGGGC
AGAGTTACACTGGGGGCTTACCATATGAGC|ATGTTATTTCTCGCGCAGCCGGTTGACTGT
GCTTCGTAGCGGCGAGCGGATTCTCGCTTA|GTGGGCGGAAAGTACAACGAGCGCATATGC
CGCCGTTACACTGGGGGCTTACCATATGAG|GGAGAGATATTGTTCCGCTTCGACACAGGA
TATGAGCCCAGTTACACTGGGGGCTTACCA|CGCTTATGTGCGGATTGGCGGAGACAGCAC
CCATATGAGCCCATTACTAAAGGGCCACGT|GAACGATAAACCCTATTCAGTTACACTGGG
TTAGGCATCCCAAGTGGTTTCATAAAGGCT|GCGGCGGCTCGCGGGACTTCCTGAAACCAT
CAAGTAGATCTATGCTAGGTGGGCGTCATT|AACCGGTATGTAGACGTTAGGCATCCCAAG
ATATGAGCCCAGCGGTTACGGGACCGACGA|CAATGAGCCCATCGTCCCCGTTCGTATTTC
GGGGCTTACCATATGAGCCCAGGATGCTCT|CTATAATAGACAATGGCTCTGATGAGTAAT
TACCATATGAGCCCACTGTCCAAGTCAGGG|CGTCAGAGTTACACTGGGGGCTTACCATAT
CTTACCATATGAGCCCAGGAACGATAAACC|AGTGGACACAGGCTGAGCTCACTGGGGGTA
TCTTGAAATCCCCGCCACTACAGTACACGT|AATAGAACCGCCTGTTGTGATCAGGCTGAG
TGAAATCCCCGCCACTACAGTACACGTTAC|AGAACCGCCTGTTGTGATCAGGCTGAGCTC
GGGGGCTTACCATATGAGCCCAGGCGTGCG|TTACACGTTACACTGGGGGCTTACCATATG
TATGTAGACGTTAGGCATCCCAAGTGGTTT|TCAGGGGACGGCGGCGGCTCGCGGGACTTC
ATATGAGCCCAAAAACAAAAGAAACATGTC|ACCATCTCGTTACACTGGGGGCTTACCATA
GCCTGGTGCGACGTTACACTGGGGGCTTAC|CCAGTTACACTGGGGGCTTACCATATGAGC
GCTCACTGGGGGTATAAGGTGCACAAAAAT|GCTTACCATATGAGCCCAGCGGTTACGGGA
AGGCTGTAACCGCGTCAGAGTTACACTGGG|ACCATGACAGCCACTAATGTTATTTCTCGC
GAAGTAACCATCTCGTTACACTGGGGGCTT|CGAGCAAAGCTAAAGGCTCCCTTGGTTACA
ATCGTCCCCGTTCGTATTTCTTAGTTTCCA|TCACTGGTAAATAGGGTTACACTGGGGGCT
GCAAGTAGATCTATGCTAGGTGGGCGTCAT|TAACCGGTATGTAGACGTTAGGCATCCCAA
TCAGGCTGAGCTCCTGAATCACCTGGCTAT|CATATGAGCCCACTGTCCAAGTCAGGGTTC
CTCGCAAAACCCTGAACGTAAAGTATAGGA|CGCCGTTACACTGGGGGCTTACCATATGAG
GCTCTTGAAATCCCCGCCACTACAGTACAC|GTAATAGAACCGCCTGTTGTGATCAGGCTG
AAGCTTCGTAGCGGCGAGCGGATTCTCGCT|CGGTGGGCGGAAAGTACAACGAGCGCATAT
GTCTCCCTAAGTGTAGTTTGAATGTACACC|AAGAAACATGTCCAATGATTAGGTGGGGAC
AGTAGATCTATGCTAGGTGGGCGTCATTGG|CCGGTATGTAGACGTTAGGCATCCCAAGTG
ATTTCTTAGTTTCCATGGCCAGCTACTACG|GTTACACTGGGGGCTTACCATATGAGCCCA
CTGCGGTGGGCGGAAAGTACAACGAGCGCA|AGCCCATGGGGGCTTACCATATGAGCCCAG
GCTTACCATATGAGCCCAGCATATACACGC|CAGCCGGTTGACTGTAACCAGAGAGTGGGA
CCGAATCAAGGAATGGTCCGAGACGCCTGG|ACACTGGGGGCTTACCATATGAGCCCAGTT
CTCGAAGTAACCATCTCGTTACACTGGGGG|CGACGAGCAAAGCTAAAGGCTCCCTTGGTT
GATCAGGCTGAGCTCCTGAATCACCTGGCT|ACCATATGAGCCCACTGTCCAAGTCAGGGT
TGAACGTAAAGTATAGGATAACCGGTATGT|GGGGGCTTACCATATGAGCCCAGGATCAGG
CAAGGAATGGTCCGAGACGCCTGGTGCGAC|GGGGCTTACCATATGAGCCCAGTTACACTG
TATGTATGACCGATGCATTCTGTGGTAAGA|CGGATGTCGGCATTCTCGCAAAACCCTGAA
ATCCGGCCTAATGTTACGTCAAGAGAGTGG|AAGGAATGGTCCGAGACGCCTGGTGCGACG
AAGAGAGTGGACACAGGCTGAGCTCACTGG|TGGTGCGACGTTACACTGGGGGCTTACCAT
GGTGGGCGTCATTGGCCGCTCGTTACACTG|TAGGCATCCCAAGTGGTTTCATAAAGGCTG
TCCCAAGTGGTTTCATAAAGGCTGTAACCG|CTCGCGGGACTTCCTGAAACCATGACAGCC
GAGACAGCACACCGGAAGACAAGAGTGATC|TTACCATATGAGCCCAGGATGCTCTTGAAA
GGGCCACGTGTCCACACCCCAGCGTCGCAC|TACACTGGGGGCTTACCATATGAGCCCAAA
GCATTCTCGCAAAACCCTGAACGTAAAGTA|ATACACGCCGTTACACTGGGGGCTTACCAT
GTCGCACTTCCCGTCTCCCTAAGTGTAGTT|GCCCAAAAACAAAAGAAACATGTCCAATGA
CACAGGCTGAGCTCACTGGGGGTATAAGGT|TACACTGGGGGCTTACCATATGAGCCCAGC
ATAAAGGCTGTAACCGCGTCAGAGTTACAC|TGAAACCATGACAGCCACTAATGTTATTTC
TCACCTGGCTATATGTATGACCGATGCATT|AAGTCAGGGTTCGGATGTCGGCATTCTCGC
GTGGGCGTCATTGGCCGCTCGTTACACTGG|AGGCATCCCAAGTGGTTTCATAAAGGCTGT
AGCGCATATGCGTTACACTGGGGGCTTACC|GCCCAGAATCTCGTGTTTCGCTATAATAGA
GCATCCCAAGTGGTTTCATAAAGGCTGTAA|CGGCTCGCGGGACTTCCTGAAACCATGACA
TGGACACAGGCTGAGCTCACTGGGGGTATA|ACGTTACACTGGGGGCTTACCATATGAGCC
CACTGGGGGCTTACCATATGAGCCCAATGA|TTGGCGGAGACAGCACACCGGAAGACAAGA
TACACTGGGGGCTTACCATATGAGCCCAGT|TAGCGGCGAGCGGATTCTCGCTTATGTGCG
GGAATGGTCCGAGACGCCTGGTGCGACGTT|GCTTACCATATGAGCCCAGTTACACTGGGG
ACACTGGGGGCTTACCATATGAGCCCAGGC|ACACGTTACACGTTACACTGGGGGCTTACC
GGGCGTCATTGGCCGCTCGTTACACTGGGG|GCATCCCAAGTGGTTTCATAAAGGCTGTAA
TGTGGTAAGATCCCGTCAAATTGTGCAAGT|AAACCCTGAACGTAAAGTATAGGATAACCG
GAATCTCGTGTTTCGCTATAATAGACAATG|ATTGTGCAAGTAGATCTATGCTAGGTGGGC
AAGTGGTTTCATAAAGGCTGTAACCGCGTC|CGGGACTTCCTGAAACCATGACAGCCACTA
CCAGGATGCTCTTGAAATCCCCGCCACTAC|CTGATGAGTAATAGAACCGCCTGTTGTGAT
TTGTGCAAGTAGATCTATGCTAGGTGGGCG|AGGATAACCGGTATGTAGACGTTAGGCATC
GCCCACATAGGGAGTTACACTGGGGGCTTA|TTACACTGGGGGCTTACCATATGAGCCCAG
ACGTGTCCACACCCCAGCGTCGCACTTCCC|TGGGGGCTTACCATATGAGCCCAAAAACAA
TATGAGCCCACTGTCCAAGTCAGGGTTCGG|GAGTTACACTGGGGGCTTACCATATGAGCC
TGGGGGCTTACCATATGAGCCCAATGAGCC|GCGGAGACAGCACACCGGAAGACAAGAGTG
CCGGTATGTAGACGTTAGGCATCCCAAGTG|AGGATCAGGGGACGGCGGCGGCTCGCGGGA
TTACCATATGAGCCCAGGATGCTCTTGAAA|ATAGACAATGGCTCTGATGAGTAATAGAAC
GTAAATAGGGTTACACTGGGGGCTTACCAT|CGCCACTACAGTACACGTTACACGTTACAC
TCGCACTTCCCGTCTCCCTAAGTGTAGTTT|CCCAAAAACAAAAGAAACATGTCCAATGAT
TACACGCCGTTACACTGGGGGCTTACCATA|AGTGGGAGAGATATTGTTCCGCTTCGACAC
ATGTCCAATGATTAGGTGGGGACTATCCGG|CCATATGAGCCCAGGGTCCGAATCAAGGAA
TCTGTGGTAAGATCCCGTCAAATTGTGCAA|CAAAACCCTGAACGTAAAGTATAGGATAAC
TACAGTAACCTATATACGCCCACATAGGGA|ACCAGCGCTAACCATCGTTACACTGGGGGC
CCCTTGGTTACACTGGGGGCTTACCATGTT|AGCTACTACGATCGAGGGAGGAAGCTTCGT
ACCCCAGCGTCGCACTTCCCGTCTCCCTAA|CCATATGAGCCCAAAAACAAAAGAAACATG
GGTCCGAATCAAGGAATGGTCCGAGACGCC|GTTACACTGGGGGCTTACCATATGAGCCCA
TGTAGACGTTAGGCATCCCAAGTGGTTTCA|AGGGGACGGCGGCGGCTCGCGGGACTTCCT
ATGAGCCCAAAAACAAAAGAAACATGTCCA|CATCTCGTTACACTGGGGGCTTACCATATG
CCTTGGTTACACTGGGGGCTTACCATGTTA|GCTACTACGATCGAGGGAGGAAGCTTCGTA
ATATGCGTTACACTGGGGGCTTACCATATG|GAATCTCGTGTTTCGCTATAATAGACAATG
ATGAGCCCAGGAACGATAAACCCTATTCAG|CAGGCTGAGCTCACTGGGGGTATAAGGTGC
TGTACACCAGCGCTAACCATCGTTACACTG|GTGGGGACTATCCGGCCTAATGTTACGTCA
CGACGAGCAAAGCTAAAGGCTCCCTTGGTT|TATTTCTTAGTTTCCATGGCCAGCTACTAC
CATATGAGCCCAGAATCTCGTGTTTCGCTA|AGATCCCGTCAAATTGTGCAAGTAGATCTA
GGGGCTTACCATGTTACACTGGGGGCTTAC|GGGAGGAAGCTTCGTAGCGGCGAGCGGATT
AGTTACACTGGGGGCTTACCATATGAGCCC|GCACAAAAATCCTCGAAGTAACCATCTCGT
CCGTTCGTATTTCTTAGTTTCCATGGCCAG|TAAATAGGGTTACACTGGGGGCTTACCATA
TGAGCCCAGCATATACACGCCGTTACACTG|ACTGTAACCAGAGAGTGGGAGAGATATTGT
TTACCATATGAGCCCATTACTAAAGGGCCA|CAGGAACGATAAACCCTATTCAGTTACACT
GTTACACTGGGGGCTTACCATATGAGCCCA|CGTGTTTCGCTATAATAGACAATGGCTCTG
AATAGGGTTACACTGGGGGCTTACCATATG|CACTACAGTACACGTTACACGTTACACTGG
GGTCCGAGACGCCTGGTGCGACGTTACACT|CCATATGAGCCCAGTTACACTGGGGGCTTA
TATGAGCCCATTACTAAAGGGCCACGTGTC|CGATAAACCCTATTCAGTTACACTGGGGGC
AGCTAAAGGCTCCCTTGGTTACACTGGGGG|TTTCCATGGCCAGCTACTACGATCGAGGGA
CTGAACGTAAAGTATAGGATAACCGGTATG|TGGGGGCTTACCATATGAGCCCAGGATCAG
GCGACGTTACACTGGGGGCTTACCATATGA|CACTGGGGGCTTACCATATGAGCCCAATGA
TATCCGGCCTAATGTTACGTCAAGAGAGTG|CAAGGAATGGTCCGAGACGCCTGGTGCGAC
CTCCCTAAGTGTAGTTTGAATGTACACCAG|GAAACATGTCCAATGATTAGGTGGGGACTA
GCGCTGCGGTGGGCGGAAAGTACAACGAGC|ATGAGCCCATGGGGGCTTACCATATGAGCC
CATATGAGCCCAGGGTCCGAATCAAGGAAT|GGGGGCTTACCATGTTACACTGGGGGCTTA
TTAGGTGGGGACTATCCGGCCTAATGTTAC|CAGGGTCCGAATCAAGGAATGGTCCGAGAC
TCTCGCTTATGTGCGGATTGGCGGAGACAG|CGCATATGCGTTACACTGGGGGCTTACCAT
CACTGGGGGCTTACCATATGAGCCCAGGAA|CGTCAAGAGAGTGGACACAGGCTGAGCTCA
TACCATATGAGCCCAGGAACGATAAACCCT|TGGACACAGGCTGAGCTCACTGGGGGTATA
ATATGAGCCCAGTTACACTGGGGGCTTACC|TCGCTTATGTGCGGATTGGCGGAGACAGCA
CGCTGCGGTGGGCGGAAAGTACAACGAGCG|TGAGCCCATGGGGGCTTACCATATGAGCCC
TTTCCATGGCCAGCTACTACGATCGAGGGA|GGGGCTTACCATATGAGCCCAGGCGTGCGC
CCCCGTTCGTATTTCTTAGTTTCCATGGCC|GGTAAATAGGGTTACACTGGGGGCTTACCA
GGGCTTACCATATGAGCCCAGAATCTCGTG|CTGTGGTAAGATCCCGTCAAATTGTGCAAG
GGGCTTACCATATGAGCCCAGGATGCTCTT|TATAATAGACAATGGCTCTGATGAGTAATA
CGGCGAGCGGATTCTCGCTTATGTGCGGAT|AAGTACAACGAGCGCATATGCGTTACACTG
CTGGGGGCTTACCATATGAGCCCAGGGTCC|CTTGGTTACACTGGGGGCTTACCATGTTAC
TAAAGTATAGGATAACCGGTATGTAGACGT|TTACCATATGAGCCCAGGATCAGGGGACGG
TGAGCCCATTACTAAAGGGCCACGTGTCCA|ATAAACCCTATTCAGTTACACTGGGGGCTT
CGTCGCACTTCCCGTCTCCCTAAGTGTAGT|AGCCCAAAAACAAAAGAAACATGTCCAATG
CGTTCGTATTTCTTAGTTTCCATGGCCAGC|AAATAGGGTTACACTGGGGGCTTACCATAT
ACAGCACACCGGAAGACAAGAGTGATCACT|CCATATGAGCCCAGGATGCTCTTGAAATCC
AATCTCGTGTTTCGCTATAATAGACAATGG|TTGTGCAAGTAGATCTATGCTAGGTGGGCG
CTTACCATATGAGCCCAGAATCTCGTGTTT|TGGTAAGATCCCGTCAAATTGTGCAAGTAG
GCTCGTTACACTGGGGGCTTACCATATGAG|TTCATAAAGGCTGTAACCGCGTCAGAGTTA
TATGCTAGGTGGGCGTCATTGGCCGCTCGT|TAGACGTTAGGCATCCCAAGTGGTTTCATA
CTGGGGGCTTACCATATGAGCCCAGCATAT|CTCGCGCAGCCGGTTGACTGTAACCAGAGA
TCAGAGTTACACTGGGGGCTTACCATATGA|TAATGTTATTTCTCGCGCAGCCGGTTGACT
ATATGAGCCCAGCATATACACGCCGTTACA|TTGACTGTAACCAGAGAGTGGGAGAGATAT
ATGTCGGCATTCTCGCAAAACCCTGAACGT|CAGCATATACACGCCGTTACACTGGGGGCT
AGTCAGGGTTCGGATGTCGGCATTCTCGCA|TACCATATGAGCCCAGCATATACACGCCGT
AGTGTAGTTTGAATGTACACCAGCGCTAAC|GTCCAATGATTAGGTGGGGACTATCCGGCC
ACCGCCTGTTGTGATCAGGCTGAGCTCCTG|CACTGGGGGCTTACCATATGAGCCCACTGT
AGCCCAGAATCTCGTGTTTCGCTATAATAG|CGTCAAATTGTGCAAGTAGATCTATGCTAG
GGCTTACCATATGAGCCCAGGATGCTCTTG|ATAATAGACAATGGCTCTGATGAGTAATAG
AGGCGTGCGCTGCGGTGGGCGGAAAGTACA|TACCATATGAGCCCATGGGGGCTTACCATA
GGGGGCTTACCATGTTACACTGGGGGCTTA|AGGGAGGAAGCTTCGTAGCGGCGAGCGGAT
ATGAGCCCAGTTACACTGGGGGCTTACCAT|GCTTATGTGCGGATTGGCGGAGACAGCACA
GGCTGAGCTCCTGAATCACCTGGCTATATG|ATGAGCCCACTGTCCAAGTCAGGGTTCGGA
GGGCTTACCATATGAGCCCAGGGTCCGAAT|GTTACACTGGGGGCTTACCATGTTACACTG
ATGATTAGGTGGGGACTATCCGGCCTAATG|AGCCCAGGGTCCGAATCAAGGAATGGTCCG
CGTTACACTGGGGGCTTACCATATGAGCCC|TGAATCACCTGGCTATATGTATGACCGATG
CAGGAACGATAAACCCTATTCAGTTACACT|AGCTCACTGGGGGTATAAGGTGCACAAAAA
ACAAGAGTGATCACTGGTAAATAGGGTTAC|ATGCTCTTGAAATCCCCGCCACTACAGTAC
TGTTACACTGGGGGCTTACCATATGAGCCC|TCGTAGCGGCGAGCGGATTCTCGCTTATGT
CCCATTACTAAAGGGCCACGTGTCCACACC|ACCCTATTCAGTTACACTGGGGGCTTACCA
GCCGCTCGTTACACTGGGGGCTTACCATAT|GGTTTCATAAAGGCTGTAACCGCGTCAGAG
ACCATCGTTACACTGGGGGCTTACCATATG|CCTAATGTTACGTCAAGAGAGTGGACACAG
CCATGGCCAGCTACTACGATCGAGGGAGGA|GCTTACCATATGAGCCCAGGCGTGCGCTGC
AGACAATGGCTCTGATGAGTAATAGAACCG|AGGTGGGCGTCATTGGCCGCTCGTTACACT
TATACGCCCACATAGGGAGTTACACTGGGG|CATCGTTACACTGGGGGCTTACCATATGAG
GGTAAGATCCCGTCAAATTGTGCAAGTAGA|CCCTGAACGTAAAGTATAGGATAACCGGTA
AATCCCCGCCACTACAGTACACGTTACACG|ACCGCCTGTTGTGATCAGGCTGAGCTCCTG
CCGAGACGCCTGGTGCGACGTTACACTGGG|TATGAGCCCAGTTACACTGGGGGCTTACCA
AGGGAGTTACACTGGGGGCTTACCATATGA|GGGGCTTACCATATGAGCCCAGGAACGATA
CTGTCCAAGTCAGGGTTCGGATGTCGGCAT|GGGGGCTTACCATATGAGCCCAGCATATAC
CTTATGTGCGGATTGGCGGAGACAGCACAC|ATGCGTTACACTGGGGGCTTACCATATGAG
TACCATATGAGCCCAATGAGCCCATCGTCC|AGCACACCGGAAGACAAGAGTGATCACTGG
CTGAATCACCTGGCTATATGTATGACCGAT|TGTCCAAGTCAGGGTTCGGATGTCGGCATT
CTTACCATATGAGCCCAATGAGCCCATCGT|ACAGCACACCGGAAGACAAGAGTGATCACT
CTATAATAGACAATGGCTCTGATGAGTAAT|CTATGCTAGGTGGGCGTCATTGGCCGCTCG
ACGTTACACTGGGGGCTTACCATATGAGCC|TGGGGGCTTACCATATGAGCCCAATGAGCC
CAAATTGTGCAAGTAGATCTATGCTAGGTG|GTATAGGATAACCGGTATGTAGACGTTAGG
GAGCCCATTACTAAAGGGCCACGTGTCCAC|TAAACCCTATTCAGTTACACTGGGGGCTTA
GGAGGAAGCTTCGTAGCGGCGAGCGGATTC|CGCTGCGGTGGGCGGAAAGTACAACGAGCG
GAGCCCAGAATCTCGTGTTTCGCTATAATA|CCGTCAAATTGTGCAAGTAGATCTATGCTA
AACGAGCGCATATGCGTTACACTGGGGGCT|ATGAGCCCAGAATCTCGTGTTTCGCTATAA
AAGCTAAAGGCTCCCTTGGTTACACTGGGG|GTTTCCATGGCCAGCTACTACGATCGAGGG
GCGGATTGGCGGAGACAGCACACCGGAAGA|ACACTGGGGGCTTACCATATGAGCCCAGGA
CTCCCTTGGTTACACTGGGGGCTTACCATG|CCAGCTACTACGATCGAGGGAGGAAGCTTC
ACACGCCGTTACACTGGGGGCTTACCATAT|GTGGGAGAGATATTGTTCCGCTTCGACACA
ATCGTTACACTGGGGGCTTACCATATGAGC|AATGTTACGTCAAGAGAGTGGACACAGGCT
CGATGCATTCTGTGGTAAGATCCCGTCAAA|CATTCTCGCAAAACCCTGAACGTAAAGTAT
GTCGGCATTCTCGCAAAACCCTGAACGTAA|GCATATACACGCCGTTACACTGGGGGCTTA
GTTACACTGGGGGCTTACCATATGAGCCCA|CGTAGCGGCGAGCGGATTCTCGCTTATGTG
CACATAGGGAGTTACACTGGGGGCTTACCA|CACTGGGGGCTTACCATATGAGCCCAGGAA
TCCGAATCAAGGAATGGTCCGAGACGCCTG|TACACTGGGGGCTTACCATATGAGCCCAGT
CTTACCATATGAGCCCATTACTAAAGGGCC|CCAGGAACGATAAACCCTATTCAGTTACAC
GGCTTACCATATGAGCCCAATGAGCCCATC|AGACAGCACACCGGAAGACAAGAGTGATCA
ATGCTAGGTGGGCGTCATTGGCCGCTCGTT|AGACGTTAGGCATCCCAAGTGGTTTCATAA
TACCATATGAGCCCAGGATGCTCTTGAAAT|TAGACAATGGCTCTGATGAGTAATAGAACC
ATGCGTTACACTGGGGGCTTACCATATGAG|ATCTCGTGTTTCGCTATAATAGACAATGGC
ACTGGGGGCTTACCATATGAGCCCAGGAAC|GTCAAGAGAGTGGACACAGGCTGAGCTCAC
GGGGCTTACCATATGAGCCCATTACTAAAG|GAGCCCAGGAACGATAAACCCTATTCAGTT
TAACCGGTATGTAGACGTTAGGCATCCCAA|CCCAGGATCAGGGGACGGCGGCGGCTCGCG
CTGGGGGCTTACCATATGAGCCCAAAAACA|AATCCTCGAAGTAACCATCTCGTTACACTG
TAATAGACAATGGCTCTGATGAGTAATAGA|TGCTAGGTGGGCGTCATTGGCCGCTCGTTA
CCCTAAGTGTAGTTTGAATGTACACCAGCG|AACATGTCCAATGATTAGGTGGGGACTATC
CCAAGTCAGGGTTCGGATGTCGGCATTCTC|GCTTACCATATGAGCCCAGCATATACACGC
CTGGCTATATGTATGACCGATGCATTCTGT|CAGGGTTCGGATGTCGGCATTCTCGCAAAA
ATCACCTGGCTATATGTATGACCGATGCAT|CAAGTCAGGGTTCGGATGTCGGCATTCTCG
CCCAGAATCTCGTGTTTCGCTATAATAGAC|TCAAATTGTGCAAGTAGATCTATGCTAGGT
GACGTTACACTGGGGGCTTACCATATGAGC|CTGGGGGCTTACCATATGAGCCCAATGAGC
CATGGCCAGCTACTACGATCGAGGGAGGAA|CTTACCATATGAGCCCAGGCGTGCGCTGCG
TATATGTATGACCGATGCATTCTGTGGTAA|TTCGGATGTCGGCATTCTCGCAAAACCCTG
TCACTGGGGGTATAAGGTGCACAAAAATCC|TTACCATATGAGCCCAGCGGTTACGGGACC
ACACTGGGGGCTTACCATATGAGCCCAGCG|GCTTACCATATGAGCCCAATGAGCCCATCG
CTGGGGGCTTACCATATGAGCCCAGGAACG|TCAAGAGAGTGGACACAGGCTGAGCTCACT
AAAATCCTCGAAGTAACCATCTCGTTACAC|CGGGACCGACGAGCAAAGCTAAAGGCTCCC
AGTTACACTGGGGGCTTACCATATGAGCCC|GTTATTTCTCGCGCAGCCGGTTGACTGTAA
GGGTTACACTGGGGGCTTACCATATGAGCC|ACAGTACACGTTACACGTTACACTGGGGGC
GCTTACCATGTTACACTGGGGGCTTACCAT|AGGAAGCTTCGTAGCGGCGAGCGGATTCTC
AGTTACACTGGGGGCTTACCATATGAGCCC|GCGGATTGGCGGAGACAGCACACCGGAAGA
TGAGCCCAGGAACGATAAACCCTATTCAGT|AGGCTGAGCTCACTGGGGGTATAAGGTGCA
AGGGCCACGTGTCCACACCCCAGCGTCGCA|TTACACTGGGGGCTTACCATATGAGCCCAA
TAGGGTTACACTGGGGGCTTACCATATGAG|CTACAGTACACGTTACACGTTACACTGGGG
CATATGAGCCCAGTTACACTGGGGGCTTAC|CTCGCTTATGTGCGGATTGGCGGAGACAGC
TGTATGACCGATGCATTCTGTGGTAAGATC|GATGTCGGCATTCTCGCAAAACCCTGAACG
CGCGTCAGAGTTACACTGGGGGCTTACCAT|CCACTAATGTTATTTCTCGCGCAGCCGGTT
AAGGTGCACAAAAATCCTCGAAGTAACCAT|CCAGCGGTTACGGGACCGACGAGCAAAGCT
GAGCCCAGCGGTTACGGGACCGACGAGCAA|GAGCCCATCGTCCCCGTTCGTATTTCTTAG
CGGAAAGTACAACGAGCGCATATGCGTTAC|GGCTTACCATATGAGCCCAGAATCTCGTGT
ATCAGGCTGAGCTCCTGAATCACCTGGCTA|CCATATGAGCCCACTGTCCAAGTCAGGGTT
ATATGAGCCCAATGAGCCCATCGTCCCCGT|CACCGGAAGACAAGAGTGATCACTGGTAAA
GCGCATATGCGTTACACTGGGGGCTTACCA|CCCAGAATCTCGTGTTTCGCTATAATAGAC
CTGTTGTGATCAGGCTGAGCTCCTGAATCA|GGGGCTTACCATATGAGCCCACTGTCCAAG
GTTCGTATTTCTTAGTTTCCATGGCCAGCT|AATAGGGTTACACTGGGGGCTTACCATATG
GATGTCGGCATTCTCGCAAAACCCTGAACG|CCAGCATATACACGCCGTTACACTGGGGGC
CATATGAGCCCAGGAACGATAAACCCTATT|ACACAGGCTGAGCTCACTGGGGGTATAAGG
TAAAGGCTGTAACCGCGTCAGAGTTACACT|GAAACCATGACAGCCACTAATGTTATTTCT
ATGAGTAATAGAACCGCCTGTTGTGATCAG|GGCCGCTCGTTACACTGGGGGCTTACCATA
CTATATACGCCCACATAGGGAGTTACACTG|AACCATCGTTACACTGGGGGCTTACCATAT
GCATTCTGTGGTAAGATCCCGTCAAATTGT|CTCGCAAAACCCTGAACGTAAAGTATAGGA
TGAGCCCATGGGGGCTTACCATATGAGCCC|ACCGATGCATTCTGTGGTAAGATCCCGTCA
CGGCATTCTCGCAAAACCCTGAACGTAAAG|ATATACACGCCGTTACACTGGGGGCTTACC
ATATGTATGACCGATGCATTCTGTGGTAAG|TCGGATGTCGGCATTCTCGCAAAACCCTGA
AACCATCTCGTTACACTGGGGGCTTACCAT|AAAGCTAAAGGCTCCCTTGGTTACACTGGG
TGGTTACACTGGGGGCTTACCATGTTACAC|ACTACGATCGAGGGAGGAAGCTTCGTAGCG
ACTGTCCAAGTCAGGGTTCGGATGTCGGCA|TGGGGGCTTACCATATGAGCCCAGCATATA
ACTATCCGGCCTAATGTTACGTCAAGAGAG|ATCAAGGAATGGTCCGAGACGCCTGGTGCG
TGAGCTCCTGAATCACCTGGCTATATGTAT|AGCCCACTGTCCAAGTCAGGGTTCGGATGT
AAAACCCTGAACGTAAAGTATAGGATAACC|TTACACTGGGGGCTTACCATATGAGCCCAG
CTGGGGGCTTACCATGTTACACTGGGGGCT|CGAGGGAGGAAGCTTCGTAGCGGCGAGCGG
GAGTTACACTGGGGGCTTACCATATGAGCC|TGTTATTTCTCGCGCAGCCGGTTGACTGTA
GAGCGCATATGCGTTACACTGGGGGCTTAC|AGCCCAGAATCTCGTGTTTCGCTATAATAG
GTCAGAGTTACACTGGGGGCTTACCATATG|CTAATGTTATTTCTCGCGCAGCCGGTTGAC
TGGGGGCTTACCATATGAGCCCAGGGTCCG|TTGGTTACACTGGGGGCTTACCATGTTACA
CTTACCATGTTACACTGGGGGCTTACCATA|GGAAGCTTCGTAGCGGCGAGCGGATTCTCG
GAGCCCAGCATATACACGCCGTTACACTGG|CTGTAACCAGAGAGTGGGAGAGATATTGTT
AAAGGGCCACGTGTCCACACCCCAGCGTCG|AGTTACACTGGGGGCTTACCATATGAGCCC
ACAATGGCTCTGATGAGTAATAGAACCGCC|GTGGGCGTCATTGGCCGCTCGTTACACTGG
GCTTACCATATGAGCCCATGGGGGCTTACC|TATATGTATGACCGATGCATTCTGTGGTAA
TTACGTCAAGAGAGTGGACACAGGCTGAGC|AGACGCCTGGTGCGACGTTACACTGGGGGC
TGTAACCGCGTCAGAGTTACACTGGGGGCT|TGACAGCCACTAATGTTATTTCTCGCGCAG
ATATGAGCCCAGAATCTCGTGTTTCGCTAT|GATCCCGTCAAATTGTGCAAGTAGATCTAT
AAGGAATGGTCCGAGACGCCTGGTGCGACG|GGGCTTACCATATGAGCCCAGTTACACTGG
GAGCTCACTGGGGGTATAAGGTGCACAAAA|GGGCTTACCATATGAGCCCAGCGGTTACGG
GACTATCCGGCCTAATGTTACGTCAAGAGA|AATCAAGGAATGGTCCGAGACGCCTGGTGC
CATGTCCAATGATTAGGTGGGGACTATCCG|ACCATATGAGCCCAGGGTCCGAATCAAGGA
CTACGATCGAGGGAGGAAGCTTCGTAGCGG|GCCCAGGCGTGCGCTGCGGTGGGCGGAAAG
TCCTCGAAGTAACCATCTCGTTACACTGGG|ACCGACGAGCAAAGCTAAAGGCTCCCTTGG
CGTTACACTGGGGGCTTACCATATGAGCCC|ATAAAGGCTGTAACCGCGTCAGAGTTACAC
TACGGGACCGACGAGCAAAGCTAAAGGCTC|CCCGTTCGTATTTCTTAGTTTCCATGGCCA
CATGTTACACTGGGGGCTTACCATATGAGC|CTTCGTAGCGGCGAGCGGATTCTCGCTTAT
TTCTCGCTTATGTGCGGATTGGCGGAGACA|GCGCATATGCGTTACACTGGGGGCTTACCA
TAAACCCTATTCAGTTACACTGGGGGCTTA|GGGGTATAAGGTGCACAAAAATCCTCGAAG
TTACACTGGGGGCTTACCATATGAGCCCAG|GTACACGTTACACGTTACACTGGGGGCTTA
GTTACACTGGGGGCTTACCATATGAGCCCA|CGGATTGGCGGAGACAGCACACCGGAAGAC
CCCCGCCACTACAGTACACGTTACACGTTA|GCCTGTTGTGATCAGGCTGAGCTCCTGAAT
ACCATATGAGCCCACTGTCCAAGTCAGGGT|GTCAGAGTTACACTGGGGGCTTACCATATG
TTTCTTAGTTTCCATGGCCAGCTACTACGA|TTACACTGGGGGCTTACCATATGAGCCCAG
GCCCAATGAGCCCATCGTCCCCGTTCGTAT|AAGACAAGAGTGATCACTGGTAAATAGGGT
AGGTGGGCGTCATTGGCCGCTCGTTACACT|TTAGGCATCCCAAGTGGTTTCATAAAGGCT
GAATGGTCCGAGACGCCTGGTGCGACGTTA|CTTACCATATGAGCCCAGTTACACTGGGGG
GTTACACTGGGGGCTTACCATATGAGCCCA|CACAAAAATCCTCGAAGTAACCATCTCGTT
GCCCAGCATATACACGCCGTTACACTGGGG|GTAACCAGAGAGTGGGAGAGATATTGTTCC
CTTACCATATGAGCCCAGCATATACACGCC|AGCCGGTTGACTGTAACCAGAGAGTGGGAG
CTGGGGGTATAAGGTGCACAAAAATCCTCG|CCATATGAGCCCAGCGGTTACGGGACCGAC
CACTGGGGGCTTACCATATGAGCCCAGCAT|TTCTCGCGCAGCCGGTTGACTGTAACCAGA
GGTTACACTGGGGGCTTACCATGTTACACT|CTACGATCGAGGGAGGAAGCTTCGTAGCGG
AATGTTACGTCAAGAGAGTGGACACAGGCT|TCCGAGACGCCTGGTGCGACGTTACACTGG
CTACTACGATCGAGGGAGGAAGCTTCGTAG|TGAGCCCAGGCGTGCGCTGCGGTGGGCGGA
AGGCTCCCTTGGTTACACTGGGGGCTTACC|TGGCCAGCTACTACGATCGAGGGAGGAAGC
TGGGGGCTTACCATATGAGCCCAGGAACGA|CAAGAGAGTGGACACAGGCTGAGCTCACTG
CAGCATATACACGCCGTTACACTGGGGGCT|ACCAGAGAGTGGGAGAGATATTGTTCCGCT
GGTTCGGATGTCGGCATTCTCGCAAAACCC|ATGAGCCCAGCATATACACGCCGTTACACT
GGCATTCTCGCAAAACCCTGAACGTAAAGT|TATACACGCCGTTACACTGGGGGCTTACCA
GAACGTAAAGTATAGGATAACCGGTATGTA|GGGGCTTACCATATGAGCCCAGGATCAGGG
ACTGGGGGCTTACCATATGAGCCCACTGTC|GCTGTAACCGCGTCAGAGTTACACTGGGGG
TACCATGTTACACTGGGGGCTTACCATATG|AAGCTTCGTAGCGGCGAGCGGATTCTCGCT
TAGACAATGGCTCTGATGAGTAATAGAACC|TAGGTGGGCGTCATTGGCCGCTCGTTACAC
TTACACTGGGGGCTTACCATATGAGCCCAG|GTAGCGGCGAGCGGATTCTCGCTTATGTGC
TATGCGTTACACTGGGGGCTTACCATATGA|AATCTCGTGTTTCGCTATAATAGACAATGG
TTACACTGGGGGCTTACCATATGAGCCCAG|GTGTTTCGCTATAATAGACAATGGCTCTGA
ATATACGCCCACATAGGGAGTTACACTGGG|CCATCGTTACACTGGGGGCTTACCATATGA
GCTAAAGGCTCCCTTGGTTACACTGGGGGC|TTCCATGGCCAGCTACTACGATCGAGGGAG
GACAAGAGTGATCACTGGTAAATAGGGTTA|GATGCTCTTGAAATCCCCGCCACTACAGTA
GATCACTGGTAAATAGGGTTACACTGGGGG|GAAATCCCCGCCACTACAGTACACGTTACA
GTAGATCTATGCTAGGTGGGCGTCATTGGC|CGGTATGTAGACGTTAGGCATCCCAAGTGG
TAAGTGTAGTTTGAATGTACACCAGCGCTA|ATGTCCAATGATTAGGTGGGGACTATCCGG
TCCAATGATTAGGTGGGGACTATCCGGCCT|TATGAGCCCAGGGTCCGAATCAAGGAATGG
GTTACACTGGGGGCTTACCATATGAGCCCA|GGGGCTTACCATATGAGCCCAATGAGCCCA
AAGATCCCGTCAAATTGTGCAAGTAGATCT|TGAACGTAAAGTATAGGATAACCGGTATGT
AACCGGTATGTAGACGTTAGGCATCCCAAG|CCAGGATCAGGGGACGGCGGCGGCTCGCGG
AGTAACCTATATACGCCCACATAGGGAGTT|AGCGCTAACCATCGTTACACTGGGGGCTTA
CAGGCGTGCGCTGCGGTGGGCGGAAAGTAC|TTACCATATGAGCCCATGGGGGCTTACCAT
AGCTCCTGAATCACCTGGCTATATGTATGA|CCCACTGTCCAAGTCAGGGTTCGGATGTCG
ATGAGCCCAGCATATACACGCCGTTACACT|GACTGTAACCAGAGAGTGGGAGAGATATTG
ACTGGGGGCTTACCATATGAGCCCAATGAG|TGGCGGAGACAGCACACCGGAAGACAAGAG
ACCATATGAGCCCAATGAGCCCATCGTCCC|GCACACCGGAAGACAAGAGTGATCACTGGT
AGGGTTCGGATGTCGGCATTCTCGCAAAAC|ATATGAGCCCAGCATATACACGCCGTTACA
CCATATGAGCCCACTGTCCAAGTCAGGGTT|TCAGAGTTACACTGGGGGCTTACCATATGA
TTACCATATGAGCCCATGGGGGCTTACCAT|TATGTATGACCGATGCATTCTGTGGTAAGA
GTGTTTCGCTATAATAGACAATGGCTCTGA|AAGTAGATCTATGCTAGGTGGGCGTCATTG
ATATACACGCCGTTACACTGGGGGCTTACC|GAGAGTGGGAGAGATATTGTTCCGCTTCGA
CAGGCTGAGCTCCTGAATCACCTGGCTATA|ATATGAGCCCACTGTCCAAGTCAGGGTTCG
CTATATGTATGACCGATGCATTCTGTGGTA|GTTCGGATGTCGGCATTCTCGCAAAACCCT
CCCGTCAAATTGTGCAAGTAGATCTATGCT|GTAAAGTATAGGATAACCGGTATGTAGACG
AGACAAGAGTGATCACTGGTAAATAGGGTT|GGATGCTCTTGAAATCCCCGCCACTACAGT
AAAGTATAGGATAACCGGTATGTAGACGTT|TACCATATGAGCCCAGGATCAGGGGACGGC
GTTACACTGGGGGCTTACCATATGAGCCCA|TTATTTCTCGCGCAGCCGGTTGACTGTAAC
TACACTGGGGGCTTACCATATGAGCCCAAT|GATTGGCGGAGACAGCACACCGGAAGACAA
ACCATATGAGCCCAGCATATACACGCCGTT|CGGTTGACTGTAACCAGAGAGTGGGAGAGA
TATATACGCCCACATAGGGAGTTACACTGG|ACCATCGTTACACTGGGGGCTTACCATATG
GGCGAGCGGATTCTCGCTTATGTGCGGATT|AGTACAACGAGCGCATATGCGTTACACTGG
GCGGTGGGCGGAAAGTACAACGAGCGCATA|CCCATGGGGGCTTACCATATGAGCCCAGAA
GGGCTTACCATATGAGCCCAATGAGCCCAT|GAGACAGCACACCGGAAGACAAGAGTGATC
CATATGAGCCCATGGGGGCTTACCATATGA|TATGACCGATGCATTCTGTGGTAAGATCCC
GACAATGGCTCTGATGAGTAATAGAACCGC|GGTGGGCGTCATTGGCCGCTCGTTACACTG
ACCATATGAGCCCAGAATCTCGTGTTTCGC|TAAGATCCCGTCAAATTGTGCAAGTAGATC
GCTACTACGATCGAGGGAGGAAGCTTCGTA|ATGAGCCCAGGCGTGCGCTGCGGTGGGCGG
GGGAGTTACACTGGGGGCTTACCATATGAG|GGGCTTACCATATGAGCCCAGGAACGATAA
ACCATATGAGCCCAGTTACACTGGGGGCTT|TTCTCGCTTATGTGCGGATTGGCGGAGACA
TAAGATCCCGTCAAATTGTGCAAGTAGATC|CTGAACGTAAAGTATAGGATAACCGGTATG
TCGCAAAACCCTGAACGTAAAGTATAGGAT|GCCGTTACACTGGGGGCTTACCATATGAGC
GGTGGGGACTATCCGGCCTAATGTTACGTC|GGTCCGAATCAAGGAATGGTCCGAGACGCC
CCAAAAACAAAAGAAACATGTCCAATGATT|GTTACACTGGGGGCTTACCATATGAGCCCA
GTACACGTTACACGTTACACTGGGGGCTTA|AGGCTGAGCTCCTGAATCACCTGGCTATAT
ACTTCCCGTCTCCCTAAGTGTAGTTTGAAT|AAAACAAAAGAAACATGTCCAATGATTAGG
CCCAGGATGCTCTTGAAATCCCCGCCACTA|TCTGATGAGTAATAGAACCGCCTGTTGTGA
AGCGGTTACGGGACCGACGAGCAAAGCTAA|ATCGTCCCCGTTCGTATTTCTTAGTTTCCA
AGATCTATGCTAGGTGGGCGTCATTGGCCG|GTATGTAGACGTTAGGCATCCCAAGTGGTT
CATCGTTACACTGGGGGCTTACCATATGAG|TAATGTTACGTCAAGAGAGTGGACACAGGC
GTCCAAGTCAGGGTTCGGATGTCGGCATTC|GGGCTTACCATATGAGCCCAGCATATACAC
GCGTCGCACTTCCCGTCTCCCTAAGTGTAG|GAGCCCAAAAACAAAAGAAACATGTCCAAT
AATGGTCCGAGACGCCTGGTGCGACGTTAC|TTACCATATGAGCCCAGTTACACTGGGGGC
CCTGAATCACCTGGCTATATGTATGACCGA|CTGTCCAAGTCAGGGTTCGGATGTCGGCAT
TGGGGGCTTACCATATGAGCCCAGCATATA|TCGCGCAGCCGGTTGACTGTAACCAGAGAG
AAATTGTGCAAGTAGATCTATGCTAGGTGG|TATAGGATAACCGGTATGTAGACGTTAGGC
CCATATGAGCCCAGCGGTTACGGGACCGAC|CCCAATGAGCCCATCGTCCCCGTTCGTATT
CGTTACACGTTACACTGGGGGCTTACCATA|GAGCTCCTGAATCACCTGGCTATATGTATG
GCCAGCTACTACGATCGAGGGAGGAAGCTT|CCATATGAGCCCAGGCGTGCGCTGCGGTGG
GATGCATTCTGTGGTAAGATCCCGTCAAAT|ATTCTCGCAAAACCCTGAACGTAAAGTATA
GTAGACGTTAGGCATCCCAAGTGGTTTCAT|GGGGACGGCGGCGGCTCGCGGGACTTCCTG
TACACTGGGGGCTTACCATGTTACACTGGG|CGATCGAGGGAGGAAGCTTCGTAGCGGCGA
ATGAGCCCAGGGTCCGAATCAAGGAATGGT|GGCTTACCATGTTACACTGGGGGCTTACCA
GCCCAGCGGTTACGGGACCGACGAGCAAAG|GCCCATCGTCCCCGTTCGTATTTCTTAGTT
GGGGCTTACCATATGAGCCCAGGAACGATA|AGAGAGTGGACACAGGCTGAGCTCACTGGG
CCATATGAGCCCAGGATGCTCTTGAAATCC|GACAATGGCTCTGATGAGTAATAGAACCGC
TGTCCAAGTCAGGGTTCGGATGTCGGCATT|GGGGCTTACCATATGAGCCCAGCATATACA
TCGTAGCGGCGAGCGGATTCTCGCTTATGT|GGCGGAAAGTACAACGAGCGCATATGCGTT
TATGAGCCCAGGGTCCGAATCAAGGAATGG|GGGCTTACCATGTTACACTGGGGGCTTACC
TGCACAAAAATCCTCGAAGTAACCATCTCG|CGGTTACGGGACCGACGAGCAAAGCTAAAG
CGTTACACTGGGGGCTTACCATATGAGCCC|TGTTACGTCAAGAGAGTGGACACAGGCTGA
GCTAGGTGGGCGTCATTGGCCGCTCGTTAC|ACGTTAGGCATCCCAAGTGGTTTCATAAAG
ATATGAGCCCAGGAACGATAAACCCTATTC|CACAGGCTGAGCTCACTGGGGGTATAAGGT
ACACTGGGGGCTTACCATATGAGCCCACTG|AGGCTGTAACCGCGTCAGAGTTACACTGGG
CTGGGGGCTTACCATATGAGCCCAGCGGTT|TACCATATGAGCCCAATGAGCCCATCGTCC
GGATAACCGGTATGTAGACGTTAGGCATCC|GAGCCCAGGATCAGGGGACGGCGGCGGCTC
GGGCTTACCATATGAGCCCAGTTACACTGG|AGCGGATTCTCGCTTATGTGCGGATTGGCG
CGGATGTCGGCATTCTCGCAAAACCCTGAA|GCCCAGCATATACACGCCGTTACACTGGGG
TGGGGGCTTACCATATGAGCCCAGCGGTTA|ACCATATGAGCCCAATGAGCCCATCGTCCC
AAGGGCCACGTGTCCACACCCCAGCGTCGC|GTTACACTGGGGGCTTACCATATGAGCCCA
GCTCCCTTGGTTACACTGGGGGCTTACCAT|GCCAGCTACTACGATCGAGGGAGGAAGCTT
ACACTGGGGGCTTACCATGTTACACTGGGG|GATCGAGGGAGGAAGCTTCGTAGCGGCGAG
CGGAAGACAAGAGTGATCACTGGTAAATAG|CCCAGGATGCTCTTGAAATCCCCGCCACTA
GCTATAATAGACAATGGCTCTGATGAGTAA|TCTATGCTAGGTGGGCGTCATTGGCCGCTC
TGAGCCCAGTTACACTGGGGGCTTACCATA|CTTATGTGCGGATTGGCGGAGACAGCACAC
CCATTACTAAAGGGCCACGTGTCCACACCC|CCCTATTCAGTTACACTGGGGGCTTACCAT
AAAGCTAAAGGCTCCCTTGGTTACACTGGG|AGTTTCCATGGCCAGCTACTACGATCGAGG
TAGGTGGGGACTATCCGGCCTAATGTTACG|AGGGTCCGAATCAAGGAATGGTCCGAGACG
TCGAAGTAACCATCTCGTTACACTGGGGGC|GACGAGCAAAGCTAAAGGCTCCCTTGGTTA
ATAATAGACAATGGCTCTGATGAGTAATAG|ATGCTAGGTGGGCGTCATTGGCCGCTCGTT
AGACGCCTGGTGCGACGTTACACTGGGGGC|GAGCCCAGTTACACTGGGGGCTTACCATAT
ACACCAGCGCTAACCATCGTTACACTGGGG|GGGACTATCCGGCCTAATGTTACGTCAAGA
TAGGGAGTTACACTGGGGGCTTACCATATG|GGGGGCTTACCATATGAGCCCAGGAACGAT
TGCGTTACACTGGGGGCTTACCATATGAGC|TCTCGTGTTTCGCTATAATAGACAATGGCT
GGGGGCTTACCATATGAGCCCATGGGGGCT|TGGCTATATGTATGACCGATGCATTCTGTG
CGTCAGAGTTACACTGGGGGCTTACCATAT|ACTAATGTTATTTCTCGCGCAGCCGGTTGA
GACGCCTGGTGCGACGTTACACTGGGGGCT|AGCCCAGTTACACTGGGGGCTTACCATATG
ACATGTCCAATGATTAGGTGGGGACTATCC|TACCATATGAGCCCAGGGTCCGAATCAAGG
ACTGGGGGCTTACCATATGAGCCCAGCATA|TCTCGCGCAGCCGGTTGACTGTAACCAGAG
GCTTACCATATGAGCCCAGGGTCCGAATCA|TACACTGGGGGCTTACCATGTTACACTGGG
GGGGACTATCCGGCCTAATGTTACGTCAAG|CCGAATCAAGGAATGGTCCGAGACGCCTGG
CGGTTACGGGACCGACGAGCAAAGCTAAAG|CGTCCCCGTTCGTATTTCTTAGTTTCCATG
CGTTACACTGGGGGCTTACCATATGAGCCC|AGGCTCCCTTGGTTACACTGGGGGCTTACC
ACCGCGTCAGAGTTACACTGGGGGCTTACC|AGCCACTAATGTTATTTCTCGCGCAGCCGG
CCCGTTCGTATTTCTTAGTTTCCATGGCCA|GTAAATAGGGTTACACTGGGGGCTTACCAT
CCCACATAGGGAGTTACACTGGGGGCTTAC|TACACTGGGGGCTTACCATATGAGCCCAGG
TCGTGTTTCGCTATAATAGACAATGGCTCT|GCAAGTAGATCTATGCTAGGTGGGCGTCAT
GCGGAAAGTACAACGAGCGCATATGCGTTA|GGGCTTACCATATGAGCCCAGAATCTCGTG
GCGAGCGGATTCTCGCTTATGTGCGGATTG|GTACAACGAGCGCATATGCGTTACACTGGG
CACTGGTAAATAGGGTTACACTGGGGGCTT|ATCCCCGCCACTACAGTACACGTTACACGT
GGCTTACCATATGAGCCCAGCGGTTACGGG|TATGAGCCCAATGAGCCCATCGTCCCCGTT
TGAGCCCAGGGTCCGAATCAAGGAATGGTC|GCTTACCATGTTACACTGGGGGCTTACCAT
ACCATGTTACACTGGGGGCTTACCATATGA|AGCTTCGTAGCGGCGAGCGGATTCTCGCTT
GGTAAATAGGGTTACACTGGGGGCTTACCA|CCGCCACTACAGTACACGTTACACGTTACA
CCAGGGTCCGAATCAAGGAATGGTCCGAGA|CCATGTTACACTGGGGGCTTACCATATGAG
TAACCGCGTCAGAGTTACACTGGGGGCTTA|ACAGCCACTAATGTTATTTCTCGCGCAGCC
TGACCGATGCATTCTGTGGTAAGATCCCGT|TCGGCATTCTCGCAAAACCCTGAACGTAAA
GCCCAGGGTCCGAATCAAGGAATGGTCCGA|TACCATGTTACACTGGGGGCTTACCATATG
CCTATATACGCCCACATAGGGAGTTACACT|TAACCATCGTTACACTGGGGGCTTACCATA
AACCGCGTCAGAGTTACACTGGGGGCTTAC|CAGCCACTAATGTTATTTCTCGCGCAGCCG
TGCGGTGGGCGGAAAGTACAACGAGCGCAT|GCCCATGGGGGCTTACCATATGAGCCCAGA
CATCGTCCCCGTTCGTATTTCTTAGTTTCC|ATCACTGGTAAATAGGGTTACACTGGGGGC
GCCCATTACTAAAGGGCCACGTGTCCACAC|AACCCTATTCAGTTACACTGGGGGCTTACC
GGGGGCTTACCATATGAGCCCAAAAACAAA|TCCTCGAAGTAACCATCTCGTTACACTGGG
TATTTCTTAGTTTCCATGGCCAGCTACTAC|GGTTACACTGGGGGCTTACCATATGAGCCC
GGCTGAGCTCACTGGGGGTATAAGGTGCAC|CTGGGGGCTTACCATATGAGCCCAGCGGTT
GGACACAGGCTGAGCTCACTGGGGGTATAA|CGTTACACTGGGGGCTTACCATATGAGCCC
CCGCCTGTTGTGATCAGGCTGAGCTCCTGA|ACTGGGGGCTTACCATATGAGCCCACTGTC
TCGCTTATGTGCGGATTGGCGGAGACAGCA|CATATGCGTTACACTGGGGGCTTACCATAT
GAGCCCAGTTACACTGGGGGCTTACCATAT|TTATGTGCGGATTGGCGGAGACAGCACACC
TGATGAGTAATAGAACCGCCTGTTGTGATC|TTGGCCGCTCGTTACACTGGGGGCTTACCA
GCTTACCATATGAGCCCATTACTAAAGGGC|CCCAGGAACGATAAACCCTATTCAGTTACA
ATGTAGACGTTAGGCATCCCAAGTGGTTTC|CAGGGGACGGCGGCGGCTCGCGGGACTTCC
TTGGTTACACTGGGGGCTTACCATGTTACA|TACTACGATCGAGGGAGGAAGCTTCGTAGC
CTGGGGGCTTACCATATGAGCCCAATGAGC|GGCGGAGACAGCACACCGGAAGACAAGAGT
CGCCTGTTGTGATCAGGCTGAGCTCCTGAA|CTGGGGGCTTACCATATGAGCCCACTGTCC
AAACCCTGAACGTAAAGTATAGGATAACCG|TACACTGGGGGCTTACCATATGAGCCCAGG
AGTGGTTTCATAAAGGCTGTAACCGCGTCA|GGGACTTCCTGAAACCATGACAGCCACTAA
TTACCATATGAGCCCAAAAACAAAAGAAAC|AAGTAACCATCTCGTTACACTGGGGGCTTA
CAGTAACCTATATACGCCCACATAGGGAGT|CAGCGCTAACCATCGTTACACTGGGGGCTT
GGCTATATGTATGACCGATGCATTCTGTGG|GGGTTCGGATGTCGGCATTCTCGCAAAACC
CAATGAGCCCATCGTCCCCGTTCGTATTTC|ACAAGAGTGATCACTGGTAAATAGGGTTAC
CGTAAAGTATAGGATAACCGGTATGTAGAC|GCTTACCATATGAGCCCAGGATCAGGGGAC
GCCACTACAGTACACGTTACACGTTACACT|GTTGTGATCAGGCTGAGCTCCTGAATCACC
CTGTGGTAAGATCCCGTCAAATTGTGCAAG|AAAACCCTGAACGTAAAGTATAGGATAACC
CATATGAGCCCACTGTCCAAGTCAGGGTTC|CAGAGTTACACTGGGGGCTTACCATATGAG
TTCGGATGTCGGCATTCTCGCAAAACCCTG|GAGCCCAGCATATACACGCCGTTACACTGG
CAGGATGCTCTTGAAATCCCCGCCACTACA|TGATGAGTAATAGAACCGCCTGTTGTGATC
CCCGTCTCCCTAAGTGTAGTTTGAATGTAC|CAAAAGAAACATGTCCAATGATTAGGTGGG
CTACAGTACACGTTACACGTTACACTGGGG|TGATCAGGCTGAGCTCCTGAATCACCTGGC
TCAAGAGAGTGGACACAGGCTGAGCTCACT|CCTGGTGCGACGTTACACTGGGGGCTTACC
CACCAGCGCTAACCATCGTTACACTGGGGG|GGACTATCCGGCCTAATGTTACGTCAAGAG
TTACTAAAGGGCCACGTGTCCACACCCCAG|TATTCAGTTACACTGGGGGCTTACCATATG
GGCTTACCATATGAGCCCAGTTACACTGGG|GCGGATTCTCGCTTATGTGCGGATTGGCGG
GATGAGTAATAGAACCGCCTGTTGTGATCA|TGGCCGCTCGTTACACTGGGGGCTTACCAT
ATCACTGGTAAATAGGGTTACACTGGGGGC|AAATCCCCGCCACTACAGTACACGTTACAC
GAATCACCTGGCTATATGTATGACCGATGC|TCCAAGTCAGGGTTCGGATGTCGGCATTCT
CCGTCTCCCTAAGTGTAGTTTGAATGTACA|AAAAGAAACATGTCCAATGATTAGGTGGGG
GAGCCCATGGGGGCTTACCATATGAGCCCA|CCGATGCATTCTGTGGTAAGATCCCGTCAA
GGCTTACCATATGAGCCCAGGCGTGCGCTG|CACGTTACACTGGGGGCTTACCATATGAGC
TAGTTTGAATGTACACCAGCGCTAACCATC|AATGATTAGGTGGGGACTATCCGGCCTAAT
GAAAGTACAACGAGCGCATATGCGTTACAC|CTTACCATATGAGCCCAGAATCTCGTGTTT
CTGGGGGCTTACCATATGAGCCCACTGTCC|CTGTAACCGCGTCAGAGTTACACTGGGGGC
GAGGGAGGAAGCTTCGTAGCGGCGAGCGGA|GTGCGCTGCGGTGGGCGGAAAGTACAACGA
GAGCCCAGGGTCCGAATCAAGGAATGGTCC|CTTACCATGTTACACTGGGGGCTTACCATA
ATTAGGTGGGGACTATCCGGCCTAATGTTA|CCAGGGTCCGAATCAAGGAATGGTCCGAGA
CTAAAGGGCCACGTGTCCACACCCCAGCGT|TCAGTTACACTGGGGGCTTACCATATGAGC
TTACCATATGAGCCCACTGTCCAAGTCAGG|GCGTCAGAGTTACACTGGGGGCTTACCATA
CACTGGGGGCTTACCATATGAGCCCAGGGT|CCCTTGGTTACACTGGGGGCTTACCATGTT
AATGATTAGGTGGGGACTATCCGGCCTAAT|GAGCCCAGGGTCCGAATCAAGGAATGGTCC
GGCTTACCATATGAGCCCAGGAACGATAAA|AGAGTGGACACAGGCTGAGCTCACTGGGGG
TGGGCGTCATTGGCCGCTCGTTACACTGGG|GGCATCCCAAGTGGTTTCATAAAGGCTGTA
GGGGGCTTACCATATGAGCCCAGCGGTTAC|CCATATGAGCCCAATGAGCCCATCGTCCCC
GTGGGGACTATCCGGCCTAATGTTACGTCA|GTCCGAATCAAGGAATGGTCCGAGACGCCT
GTAATAGAACCGCCTGTTGTGATCAGGCTG|GCTCGTTACACTGGGGGCTTACCATATGAG
AGCCCATGGGGGCTTACCATATGAGCCCAG|CGATGCATTCTGTGGTAAGATCCCGTCAAA
ATAGACAATGGCTCTGATGAGTAATAGAAC|CTAGGTGGGCGTCATTGGCCGCTCGTTACA
ACACTGGGGGCTTACCATATGAGCCCAGCA|TTTCTCGCGCAGCCGGTTGACTGTAACCAG
TGAGCCCATCGTCCCCGTTCGTATTTCTTA|AGAGTGATCACTGGTAAATAGGGTTACACT
GGGGGCTTACCATATGAGCCCACTGTCCAA|GTAACCGCGTCAGAGTTACACTGGGGGCTT
CTGGGGGCTTACCATATGAGCCCAGTTACA|GGCGAGCGGATTCTCGCTTATGTGCGGATT
GCTGAGCTCCTGAATCACCTGGCTATATGT|TGAGCCCACTGTCCAAGTCAGGGTTCGGAT
GTATGACCGATGCATTCTGTGGTAAGATCC|ATGTCGGCATTCTCGCAAAACCCTGAACGT
TACCATATGAGCCCAAAAACAAAAGAAACA|AGTAACCATCTCGTTACACTGGGGGCTTAC
ATCGAGGGAGGAAGCTTCGTAGCGGCGAGC|GGCGTGCGCTGCGGTGGGCGGAAAGTACAA
GGCTCTGATGAGTAATAGAACCGCCTGTTG|CGTCATTGGCCGCTCGTTACACTGGGGGCT
GCTTACCATATGAGCCCAATGAGCCCATCG|GACAGCACACCGGAAGACAAGAGTGATCAC
TTCTCGCAAAACCCTGAACGTAAAGTATAG|CACGCCGTTACACTGGGGGCTTACCATATG
CCTGTTGTGATCAGGCTGAGCTCCTGAATC|GGGGGCTTACCATATGAGCCCACTGTCCAA
TGGTAAATAGGGTTACACTGGGGGCTTACC|CCCGCCACTACAGTACACGTTACACGTTAC
ATGAGCCCAATGAGCCCATCGTCCCCGTTC|CCGGAAGACAAGAGTGATCACTGGTAAATA
ATCCCCGCCACTACAGTACACGTTACACGT|CCGCCTGTTGTGATCAGGCTGAGCTCCTGA
GCTTACCATATGAGCCCAGGATGCTCTTGA|TAATAGACAATGGCTCTGATGAGTAATAGA
TACAGTACACGTTACACGTTACACTGGGGG|GATCAGGCTGAGCTCCTGAATCACCTGGCT
CGCTTATGTGCGGATTGGCGGAGACAGCAC|ATATGCGTTACACTGGGGGCTTACCATATG
AATCACCTGGCTATATGTATGACCGATGCA|CCAAGTCAGGGTTCGGATGTCGGCATTCTC
CCCAGGGTCCGAATCAAGGAATGGTCCGAG|ACCATGTTACACTGGGGGCTTACCATATGA
CTAATGTTACGTCAAGAGAGTGGACACAGG|GGTCCGAGACGCCTGGTGCGACGTTACACT
TCTCGTGTTTCGCTATAATAGACAATGGCT|GTGCAAGTAGATCTATGCTAGGTGGGCGTC
AGAGTGGACACAGGCTGAGCTCACTGGGGG|TGCGACGTTACACTGGGGGCTTACCATATG
TATGAGCCCATGGGGGCTTACCATATGAGC|TGACCGATGCATTCTGTGGTAAGATCCCGT
GAGTAATAGAACCGCCTGTTGTGATCAGGC|CCGCTCGTTACACTGGGGGCTTACCATATG
AGAGAGTGGACACAGGCTGAGCTCACTGGG|GGTGCGACGTTACACTGGGGGCTTACCATA
GTGCGGATTGGCGGAGACAGCACACCGGAA|TTACACTGGGGGCTTACCATATGAGCCCAG
TTATGTGCGGATTGGCGGAGACAGCACACC|TGCGTTACACTGGGGGCTTACCATATGAGC
CGAATCAAGGAATGGTCCGAGACGCCTGGT|CACTGGGGGCTTACCATATGAGCCCAGTTA
CCATCGTCCCCGTTCGTATTTCTTAGTTTC|GATCACTGGTAAATAGGGTTACACTGGGGG
TACTACGATCGAGGGAGGAAGCTTCGTAGC|GAGCCCAGGCGTGCGCTGCGGTGGGCGGAA
TGGTAAGATCCCGTCAAATTGTGCAAGTAG|ACCCTGAACGTAAAGTATAGGATAACCGGT
GGGCTTACCATATGAGCCCACTGTCCAAGT|AACCGCGTCAGAGTTACACTGGGGGCTTAC
TGTGCAAGTAGATCTATGCTAGGTGGGCGT|GGATAACCGGTATGTAGACGTTAGGCATCC
GCGTTACACTGGGGGCTTACCATATGAGCC|CTCGTGTTTCGCTATAATAGACAATGGCTC
GGAACGATAAACCCTATTCAGTTACACTGG|CTCACTGGGGGTATAAGGTGCACAAAAATC
TGGTGCGACGTTACACTGGGGGCTTACCAT|GTTACACTGGGGGCTTACCATATGAGCCCA
GGGCTTACCATGTTACACTGGGGGCTTACC|GGAGGAAGCTTCGTAGCGGCGAGCGGATTC
GGGGGCTTACCATATGAGCCCAGGATGCTC|GCTATAATAGACAATGGCTCTGATGAGTAA
GGCTTACCATGTTACACTGGGGGCTTACCA|GAGGAAGCTTCGTAGCGGCGAGCGGATTCT
GAGACGCCTGGTGCGACGTTACACTGGGGG|TGAGCCCAGTTACACTGGGGGCTTACCATA
TTCTGTGGTAAGATCCCGTCAAATTGTGCA|GCAAAACCCTGAACGTAAAGTATAGGATAA
TATGAGCCCAAAAACAAAAGAAACATGTCC|CCATCTCGTTACACTGGGGGCTTACCATAT
AGCCCAGCGGTTACGGGACCGACGAGCAAA|AGCCCATCGTCCCCGTTCGTATTTCTTAGT
TAGGATAACCGGTATGTAGACGTTAGGCAT|ATGAGCCCAGGATCAGGGGACGGCGGCGGC
CCATATGAGCCCAAAAACAAAAGAAACATG|TAACCATCTCGTTACACTGGGGGCTTACCA
GCACTTCCCGTCTCCCTAAGTGTAGTTTGA|CAAAAACAAAAGAAACATGTCCAATGATTA
GGGGCTTACCATATGAGCCCACTGTCCAAG|TAACCGCGTCAGAGTTACACTGGGGGCTTA
AAGTAGATCTATGCTAGGTGGGCGTCATTG|ACCGGTATGTAGACGTTAGGCATCCCAAGT
ATGCTCTTGAAATCCCCGCCACTACAGTAC|GAGTAATAGAACCGCCTGTTGTGATCAGGC
GAGCAAAGCTAAAGGCTCCCTTGGTTACAC|TCTTAGTTTCCATGGCCAGCTACTACGATC
TGAATGTACACCAGCGCTAACCATCGTTAC|TTAGGTGGGGACTATCCGGCCTAATGTTAC
GGGGCTTACCATATGAGCCCATGGGGGCTT|GGCTATATGTATGACCGATGCATTCTGTGG
GTTACACTGGGGGCTTACCATGTTACACTG|TACGATCGAGGGAGGAAGCTTCGTAGCGGC
GCTGTAACCGCGTCAGAGTTACACTGGGGG|CATGACAGCCACTAATGTTATTTCTCGCGC
AACGATAAACCCTATTCAGTTACACTGGGG|CACTGGGGGTATAAGGTGCACAAAAATCCT
TATGAGCCCAGGATGCTCTTGAAATCCCCG|AATGGCTCTGATGAGTAATAGAACCGCCTG
CCCATGGGGGCTTACCATATGAGCCCAGAA|ATGCATTCTGTGGTAAGATCCCGTCAAATT
GTGTCCACACCCCAGCGTCGCACTTCCCGT|GGGGCTTACCATATGAGCCCAAAAACAAAA
TCGGCATTCTCGCAAAACCCTGAACGTAAA|CATATACACGCCGTTACACTGGGGGCTTAC
AGCCCAATGAGCCCATCGTCCCCGTTCGTA|GAAGACAAGAGTGATCACTGGTAAATAGGG
TACACTGGGGGCTTACCATATGAGCCCAGG|TACGTCAAGAGAGTGGACACAGGCTGAGCT
AGGCTGAGCTCACTGGGGGTATAAGGTGCA|ACTGGGGGCTTACCATATGAGCCCAGCGGT
CTGGGGGCTTACCATATGAGCCCAGGCGTG|CGTTACACGTTACACTGGGGGCTTACCATA
ACTACAGTACACGTTACACGTTACACTGGG|GTGATCAGGCTGAGCTCCTGAATCACCTGG
AATTGTGCAAGTAGATCTATGCTAGGTGGG|ATAGGATAACCGGTATGTAGACGTTAGGCA
CTTACCATATGAGCCCATGGGGGCTTACCA|ATATGTATGACCGATGCATTCTGTGGTAAG
ACATAGGGAGTTACACTGGGGGCTTACCAT|ACTGGGGGCTTACCATATGAGCCCAGGAAC
CAAAGCTAAAGGCTCCCTTGGTTACACTGG|TAGTTTCCATGGCCAGCTACTACGATCGAG
TATAAGGTGCACAAAAATCCTCGAAGTAAC|AGCCCAGCGGTTACGGGACCGACGAGCAAA
ATTCTCGCTTATGTGCGGATTGGCGGAGAC|AGCGCATATGCGTTACACTGGGGGCTTACC
ATGAGCCCAGGATGCTCTTGAAATCCCCGC|ATGGCTCTGATGAGTAATAGAACCGCCTGT
TACCATATGAGCCCAGGGTCCGAATCAAGG|ACTGGGGGCTTACCATGTTACACTGGGGGC
CTAACCATCGTTACACTGGGGGCTTACCAT|CGGCCTAATGTTACGTCAAGAGAGTGGACA
CGTCCCCGTTCGTATTTCTTAGTTTCCATG|ACTGGTAAATAGGGTTACACTGGGGGCTTA
CACTGGGGGTATAAGGTGCACAAAAATCCT|TACCATATGAGCCCAGCGGTTACGGGACCG
TACGATCGAGGGAGGAAGCTTCGTAGCGGC|CCCAGGCGTGCGCTGCGGTGGGCGGAAAGT
GGCTTACCATATGAGCCCAGAATCTCGTGT|TGTGGTAAGATCCCGTCAAATTGTGCAAGT
GAGTGATCACTGGTAAATAGGGTTACACTG|TCTTGAAATCCCCGCCACTACAGTACACGT
GTAACCGCGTCAGAGTTACACTGGGGGCTT|GACAGCCACTAATGTTATTTCTCGCGCAGC
GTTACACTGGGGGCTTACCATATGAGCCCA|TTACCATATGAGCCCAGGAACGATAAACCC
TGGGGGCTTACCATATGAGCCCACTGTCCA|TGTAACCGCGTCAGAGTTACACTGGGGGCT
AGGCATCCCAAGTGGTTTCATAAAGGCTGT|GGCGGCTCGCGGGACTTCCTGAAACCATGA
ACCATATGAGCCCATTACTAAAGGGCCACG|GGAACGATAAACCCTATTCAGTTACACTGG
GTGATCACTGGTAAATAGGGTTACACTGGG|TTGAAATCCCCGCCACTACAGTACACGTTA
TATGAGCCCAGCATATACACGCCGTTACAC|TGACTGTAACCAGAGAGTGGGAGAGATATT
ATCCTCGAAGTAACCATCTCGTTACACTGG|GACCGACGAGCAAAGCTAAAGGCTCCCTTG
GAAACATGTCCAATGATTAGGTGGGGACTA|GCTTACCATATGAGCCCAGGGTCCGAATCA
TTACACTGGGGGCTTACCATATGAGCCCAG|TTACGTCAAGAGAGTGGACACAGGCTGAGC
AGGATAACCGGTATGTAGACGTTAGGCATC|TGAGCCCAGGATCAGGGGACGGCGGCGGCT
CAATGATTAGGTGGGGACTATCCGGCCTAA|TGAGCCCAGGGTCCGAATCAAGGAATGGTC
GGGAGGAAGCTTCGTAGCGGCGAGCGGATT|GCGCTGCGGTGGGCGGAAAGTACAACGAGC
CGAGACGCCTGGTGCGACGTTACACTGGGG|ATGAGCCCAGTTACACTGGGGGCTTACCAT
GCCCACTGTCCAAGTCAGGGTTCGGATGTC|ACACTGGGGGCTTACCATATGAGCCCAGCA
CCTCGAAGTAACCATCTCGTTACACTGGGG|CCGACGAGCAAAGCTAAAGGCTCCCTTGGT
ACGATAAACCCTATTCAGTTACACTGGGGG|ACTGGGGGTATAAGGTGCACAAAAATCCTC
AAGACAAGAGTGATCACTGGTAAATAGGGT|AGGATGCTCTTGAAATCCCCGCCACTACAG
GGAGTTACACTGGGGGCTTACCATATGAGC|GGCTTACCATATGAGCCCAGGAACGATAAA
GTAACCTATATACGCCCACATAGGGAGTTA|GCGCTAACCATCGTTACACTGGGGGCTTAC
ACTGGTAAATAGGGTTACACTGGGGGCTTA|TCCCCGCCACTACAGTACACGTTACACGTT
CTTACCATATGAGCCCAAAAACAAAAGAAA|GAAGTAACCATCTCGTTACACTGGGGGCTT
ATGGCCAGCTACTACGATCGAGGGAGGAAG|TTACCATATGAGCCCAGGCGTGCGCTGCGG
TGAGCCCAATGAGCCCATCGTCCCCGTTCG|CGGAAGACAAGAGTGATCACTGGTAAATAG
TGCTCTTGAAATCCCCGCCACTACAGTACA|AGTAATAGAACCGCCTGTTGTGATCAGGCT
GGGGCTTACCATATGAGCCCAATGAGCCCA|GGAGACAGCACACCGGAAGACAAGAGTGAT
GGACCGACGAGCAAAGCTAAAGGCTCCCTT|TTCGTATTTCTTAGTTTCCATGGCCAGCTA
GTCAAATTGTGCAAGTAGATCTATGCTAGG|AAGTATAGGATAACCGGTATGTAGACGTTA
GCGTGCGCTGCGGTGGGCGGAAAGTACAAC|CCATATGAGCCCATGGGGGCTTACCATATG
AGGTGGGGACTATCCGGCCTAATGTTACGT|GGGTCCGAATCAAGGAATGGTCCGAGACGC
GTCAGGGTTCGGATGTCGGCATTCTCGCAA|ACCATATGAGCCCAGCATATACACGCCGTT
CAAAAATCCTCGAAGTAACCATCTCGTTAC|TACGGGACCGACGAGCAAAGCTAAAGGCTC
TCCAAGTCAGGGTTCGGATGTCGGCATTCT|GGCTTACCATATGAGCCCAGCATATACACG
TAATAGAACCGCCTGTTGTGATCAGGCTGA|CTCGTTACACTGGGGGCTTACCATATGAGC
GTGGGCGGAAAGTACAACGAGCGCATATGC|ATGGGGGCTTACCATATGAGCCCAGAATCT
AAAGGCTCCCTTGGTTACACTGGGGGCTTA|CATGGCCAGCTACTACGATCGAGGGAGGAA
CCAGCTACTACGATCGAGGGAGGAAGCTTC|CATATGAGCCCAGGCGTGCGCTGCGGTGGG
CTTAGTTTCCATGGCCAGCTACTACGATCG|CACTGGGGGCTTACCATATGAGCCCAGGCG
GGCTTACCATATGAGCCCAGGGTCCGAATC|TTACACTGGGGGCTTACCATGTTACACTGG
AACAAAAGAAACATGTCCAATGATTAGGTG|ACTGGGGGCTTACCATATGAGCCCAGGGTC
GCAAAGCTAAAGGCTCCCTTGGTTACACTG|TTAGTTTCCATGGCCAGCTACTACGATCGA
TCGGATGTCGGCATTCTCGCAAAACCCTGA|AGCCCAGCATATACACGCCGTTACACTGGG
AGCCCAGGAACGATAAACCCTATTCAGTTA|GCTGAGCTCACTGGGGGTATAAGGTGCACA
CATTCTCGCAAAACCCTGAACGTAAAGTAT|TACACGCCGTTACACTGGGGGCTTACCATA
GGTTACACTGGGGGCTTACCATATGAGCCC|CAGTACACGTTACACGTTACACTGGGGGCT
TGATTAGGTGGGGACTATCCGGCCTAATGT|GCCCAGGGTCCGAATCAAGGAATGGTCCGA
TCACTGGTAAATAGGGTTACACTGGGGGCT|AATCCCCGCCACTACAGTACACGTTACACG
TGGTTTCATAAAGGCTGTAACCGCGTCAGA|GACTTCCTGAAACCATGACAGCCACTAATG
CGTTACACTGGGGGCTTACCATATGAGCCC|TCGTGTTTCGCTATAATAGACAATGGCTCT
ACGCCCACATAGGGAGTTACACTGGGGGCT|CGTTACACTGGGGGCTTACCATATGAGCCC
CTCACTGGGGGTATAAGGTGCACAAAAATC|CTTACCATATGAGCCCAGCGGTTACGGGAC
GCCCAGTTACACTGGGGGCTTACCATATGA|ATGTGCGGATTGGCGGAGACAGCACACCGG
CCAAGTGGTTTCATAAAGGCTGTAACCGCG|CGCGGGACTTCCTGAAACCATGACAGCCAC
AGCACACCGGAAGACAAGAGTGATCACTGG|ATATGAGCCCAGGATGCTCTTGAAATCCCC
TAGCGGCGAGCGGATTCTCGCTTATGTGCG|GGAAAGTACAACGAGCGCATATGCGTTACA
CGAAGTAACCATCTCGTTACACTGGGGGCT|ACGAGCAAAGCTAAAGGCTCCCTTGGTTAC
CGCATATGCGTTACACTGGGGGCTTACCAT|CCAGAATCTCGTGTTTCGCTATAATAGACA
TACCATATGAGCCCAGTTACACTGGGGGCT|ATTCTCGCTTATGTGCGGATTGGCGGAGAC
CTCGTGTTTCGCTATAATAGACAATGGCTC|TGCAAGTAGATCTATGCTAGGTGGGCGTCA
TCGTATTTCTTAGTTTCCATGGCCAGCTAC|TAGGGTTACACTGGGGGCTTACCATATGAG
AGAATCTCGTGTTTCGCTATAATAGACAAT|AATTGTGCAAGTAGATCTATGCTAGGTGGG
CACTGGGGGCTTACCATATGAGCCCAGGCG|CACGTTACACGTTACACTGGGGGCTTACCA
CATATGCGTTACACTGGGGGCTTACCATAT|AGAATCTCGTGTTTCGCTATAATAGACAAT
GAAATCCCCGCCACTACAGTACACGTTACA|GAACCGCCTGTTGTGATCAGGCTGAGCTCC
CTTCCCGTCTCCCTAAGTGTAGTTTGAATG|AAACAAAAGAAACATGTCCAATGATTAGGT
CACAAAAATCCTCGAAGTAACCATCTCGTT|GTTACGGGACCGACGAGCAAAGCTAAAGGC
ACCGACGAGCAAAGCTAAAGGCTCCCTTGG|CGTATTTCTTAGTTTCCATGGCCAGCTACT
CATATGAGCCCAGGCGTGCGCTGCGGTGGG|CACTGGGGGCTTACCATATGAGCCCATGGG
AGCCCAGTTACACTGGGGGCTTACCATATG|TATGTGCGGATTGGCGGAGACAGCACACCG
GAGCCCAATGAGCCCATCGTCCCCGTTCGT|GGAAGACAAGAGTGATCACTGGTAAATAGG
TTACCATGTTACACTGGGGGCTTACCATAT|GAAGCTTCGTAGCGGCGAGCGGATTCTCGC
AAGTCAGGGTTCGGATGTCGGCATTCTCGC|TTACCATATGAGCCCAGCATATACACGCCG
GGGTATAAGGTGCACAAAAATCCTCGAAGT|ATGAGCCCAGCGGTTACGGGACCGACGAGC
ACTGGGGGCTTACCATATGAGCCCAAAAAC|AAATCCTCGAAGTAACCATCTCGTTACACT
AGTAATAGAACCGCCTGTTGTGATCAGGCT|CGCTCGTTACACTGGGGGCTTACCATATGA
CGAGCAAAGCTAAAGGCTCCCTTGGTTACA|TTCTTAGTTTCCATGGCCAGCTACTACGAT
CTCCTGAATCACCTGGCTATATGTATGACC|CACTGTCCAAGTCAGGGTTCGGATGTCGGC
